Date,Tm,Opp,Result,MP,FG_T,FGA_T,FG%_T,2P_T,2PA_T,2P%_T,3P_T,3PA_T,3P%_T,FT_T,FTA_T,FT%_T,PTS_T,FG_O,FGA_O,FG%_O,2P_O,2PA_O,2P%_O,3P_O,3PA_O,3P%_O,FT_O,FTA_O,FT%_O,PTS_O
2019-10-30,HOU,WAS,W 159-158,240,55,103,.534,32,49,.653,23,54,.426,26,33,.788,159,57,91,.626,37,55,.673,20,36,.556,24,29,.828,158
2019-10-30,WAS,HOU,L 158-159,240,57,91,.626,37,55,.673,20,36,.556,24,29,.828,158,55,103,.534,32,49,.653,23,54,.426,26,33,.788,159
2019-11-30,HOU,ATL,W 158-111,240,52,89,.584,27,38,.711,25,51,.490,29,34,.853,158,38,89,.427,23,43,.535,15,46,.326,20,25,.800,111
2019-11-16,LAC,ATL,W 150-101,240,50,93,.538,33,60,.550,17,33,.515,33,35,.943,150,34,90,.378,28,66,.424,6,24,.250,27,37,.730,101
2019-12-01,LAC,WAS,W 150-125,240,52,94,.553,38,62,.613,14,32,.438,32,40,.800,150,47,102,.461,36,72,.500,11,30,.367,20,27,.741,125
2019-12-23,SAS,MEM,W 145-115,240,60,89,.674,45,65,.692,15,24,.625,10,14,.714,145,45,96,.469,30,59,.508,15,37,.405,10,16,.625,115
2019-11-22,DAL,CLE,W 143-101,240,58,100,.580,38,63,.603,20,37,.541,7,9,.778,143,37,86,.430,25,57,.439,12,29,.414,15,17,.882,101
2019-12-17,NYK,ATL,W 143-120,240,53,95,.558,40,67,.597,13,28,.464,24,31,.774,143,45,99,.455,30,56,.536,15,43,.349,15,20,.750,120
2019-11-20,DAL,GSW,W 142-94,240,51,90,.567,29,52,.558,22,38,.579,18,23,.783,142,35,90,.389,27,63,.429,8,27,.296,16,25,.640,94
2019-12-08,LAL,MIN,W 142-125,240,55,94,.585,41,63,.651,14,31,.452,18,20,.900,142,44,84,.524,29,47,.617,15,37,.405,22,26,.846,125
2019-10-24,LAC,GSW,W 141-122,240,50,80,.625,32,48,.667,18,32,.563,23,30,.767,141,39,99,.394,24,57,.421,15,42,.357,29,30,.967,122
2019-12-07,PHI,CLE,W 141-94,240,57,90,.633,46,64,.719,11,26,.423,16,23,.696,141,36,96,.375,27,61,.443,9,35,.257,13,17,.765,94
2019-12-28,DAL,GSW,W 141-121,240,48,92,.522,24,41,.585,24,51,.471,21,21,1.000,141,45,93,.484,27,54,.500,18,39,.462,13,17,.765,121
2019-11-13,BOS,WAS,W 140-133,240,49,96,.510,33,60,.550,16,36,.444,26,29,.897,140,50,96,.521,39,67,.582,11,29,.379,22,27,.815,133
2019-11-27,WAS,PHO,W 140-132,240,51,89,.573,32,54,.593,19,35,.543,19,20,.950,140,48,93,.516,33,55,.600,15,38,.395,21,24,.875,132
2020-01-04,MEM,LAC,W 140-114,240,49,96,.510,31,57,.544,18,39,.462,24,28,.857,140,45,101,.446,38,71,.535,7,30,.233,17,22,.773,114
2020-01-11,BOS,NOP,W 140-105,240,55,100,.550,41,71,.577,14,29,.483,16,18,.889,140,40,100,.400,26,55,.473,14,45,.311,11,18,.611,105
2020-01-17,TOR,WAS,W 140-111,240,52,91,.571,30,48,.625,22,43,.512,14,16,.875,140,40,89,.449,25,54,.463,15,35,.429,16,23,.696,111
2019-12-05,PHO,NOP,W 139-132 (OT),265,50,106,.472,36,70,.514,14,36,.389,25,27,.926,139,44,87,.506,27,46,.587,17,41,.415,27,35,.771,132
2019-12-06,OKC,MIN,W 139-127 (OT),265,49,88,.557,44,70,.629,5,18,.278,36,40,.900,139,50,96,.521,37,58,.638,13,38,.342,14,20,.700,127
2019-12-21,HOU,PHO,W 139-125,240,51,87,.586,32,46,.696,19,41,.463,18,23,.783,139,47,91,.516,39,63,.619,8,28,.286,23,30,.767,125
2020-01-11,HOU,MIN,W 139-109,240,49,95,.516,31,50,.620,18,45,.400,23,29,.793,139,36,95,.379,23,47,.489,13,48,.271,24,36,.667,109
2019-11-09,DAL,MEM,W 138-122,240,52,97,.536,34,55,.618,18,42,.429,16,20,.800,138,50,95,.526,38,59,.644,12,36,.333,10,14,.714,122
2019-11-10,PHO,BRK,W 138-112,240,52,99,.525,33,57,.579,19,42,.452,15,19,.789,138,44,91,.484,36,57,.632,8,34,.235,16,17,.941,112
2019-11-20,WAS,SAS,W 138-132,240,54,92,.587,36,62,.581,18,30,.600,12,15,.800,138,49,93,.527,37,61,.607,12,32,.375,22,29,.759,132
2020-01-16,NOP,UTA,W 138-132 (OT),265,51,93,.548,40,67,.597,11,26,.423,25,35,.714,138,46,100,.460,31,61,.508,15,39,.385,25,32,.781,132
2019-11-06,MEM,MIN,W 137-121,240,50,88,.568,38,65,.585,12,23,.522,25,30,.833,137,43,96,.448,27,51,.529,16,45,.356,19,26,.731,121
2019-11-15,WAS,MIN,W 137-116,240,54,100,.540,44,72,.611,10,28,.357,19,25,.760,137,42,89,.472,31,52,.596,11,37,.297,21,29,.724,116
2019-11-21,MIL,POR,W 137-129,240,50,106,.472,34,63,.540,16,43,.372,21,26,.808,137,50,103,.485,33,64,.516,17,39,.436,12,14,.857,129
2019-11-24,DAL,HOU,W 137-123,240,49,102,.480,32,58,.552,17,44,.386,22,28,.786,137,45,98,.459,35,54,.648,10,44,.227,23,31,.742,123
2019-11-30,MIL,CHO,W 137-96,240,54,96,.563,34,52,.654,20,44,.455,9,15,.600,137,37,101,.366,22,56,.393,15,45,.333,7,8,.875,96
2019-11-27,POR,OKC,W 136-119,240,49,94,.521,35,64,.547,14,30,.467,24,24,1.000,136,39,88,.443,28,53,.528,11,35,.314,30,38,.789,119
2019-12-06,LAL,POR,W 136-113,240,46,85,.541,29,49,.592,17,36,.472,27,33,.818,136,39,86,.453,29,52,.558,10,34,.294,25,29,.862,113
2019-12-11,CHI,ATL,W 136-102,240,54,94,.574,43,70,.614,11,24,.458,17,19,.895,136,35,83,.422,22,45,.489,13,38,.342,19,26,.731,102
2019-12-28,SAS,DET,W 136-109,240,53,93,.570,35,58,.603,18,35,.514,12,15,.800,136,40,90,.444,28,54,.519,12,36,.333,17,30,.567,109
2019-11-04,BRK,NOP,W 135-125,240,49,92,.533,33,51,.647,16,41,.390,21,28,.750,135,48,97,.495,35,65,.538,13,32,.406,16,21,.762,125
2019-11-09,BOS,SAS,W 135-115,240,48,94,.511,34,57,.596,14,37,.378,25,28,.893,135,39,99,.394,25,69,.362,14,30,.467,23,30,.767,115
2019-11-20,MIL,ATL,W 135-127,240,46,87,.529,29,44,.659,17,43,.395,26,34,.765,135,44,96,.458,30,65,.462,14,31,.452,25,31,.806,127
2019-12-03,SAS,HOU,W 135-133 (2OT),290,50,106,.472,37,76,.487,13,30,.433,22,32,.688,135,42,111,.378,27,60,.450,15,51,.294,34,36,.944,133
2019-12-08,LAC,WAS,W 135-119,240,50,96,.521,35,56,.625,15,40,.375,20,27,.741,135,40,88,.455,26,55,.473,14,33,.424,25,30,.833,119
2019-12-10,MIA,ATL,W 135-121 (OT),265,53,103,.515,39,62,.629,14,41,.341,15,22,.682,135,45,95,.474,25,41,.610,20,54,.370,11,18,.611,121
2020-01-05,LAC,NYK,W 135-132,240,45,83,.542,27,51,.529,18,32,.563,27,33,.818,135,48,84,.571,36,61,.590,12,23,.522,24,37,.649,132
2019-10-27,MEM,BRK,W 134-133 (OT),265,50,103,.485,36,70,.514,14,33,.424,20,25,.800,134,44,101,.436,29,56,.518,15,45,.333,30,37,.811,133
2019-10-28,GSW,NOP,W 134-123,240,51,104,.490,37,69,.536,14,35,.400,18,24,.750,134,48,103,.466,33,56,.589,15,47,.319,12,22,.545,123
2019-11-04,MIL,MIN,W 134-106,240,50,93,.538,36,54,.667,14,39,.359,20,30,.667,134,37,103,.359,24,60,.400,13,43,.302,19,22,.864,106
2019-11-24,LAC,NOP,W 134-109,240,46,98,.469,30,55,.545,16,43,.372,26,33,.788,134,43,98,.439,30,57,.526,13,41,.317,10,18,.556,109
2019-12-21,LAC,SAS,W 134-109,240,54,99,.545,42,63,.667,12,36,.333,14,19,.737,134,42,82,.512,32,54,.593,10,28,.357,15,19,.789,109
2020-01-10,MEM,SAS,W 134-121,240,52,100,.520,36,62,.581,16,38,.421,14,16,.875,134,42,87,.483,25,47,.532,17,40,.425,20,23,.870,121
2020-01-16,DEN,GSW,W 134-131 (OT),265,47,100,.470,30,65,.462,17,35,.486,23,26,.885,134,42,95,.442,22,50,.440,20,45,.444,27,31,.871,131
2019-10-27,BRK,MEM,L 133-134 (OT),265,44,101,.436,29,56,.518,15,45,.333,30,37,.811,133,50,103,.485,36,70,.514,14,33,.424,20,25,.800,134
2019-11-13,WAS,BOS,L 133-140,240,50,96,.521,39,67,.582,11,29,.379,22,27,.815,133,49,96,.510,33,60,.550,16,36,.444,26,29,.897,140
2019-12-03,HOU,SAS,L 133-135 (2OT),290,42,111,.378,27,60,.450,15,51,.294,34,36,.944,133,50,106,.472,37,76,.487,13,30,.433,22,32,.688,135
2019-12-16,WAS,DET,W 133-119,240,49,88,.557,31,54,.574,18,34,.529,17,21,.810,133,41,86,.477,28,47,.596,13,39,.333,24,34,.706,119
2019-12-16,TOR,CLE,W 133-113,240,52,89,.584,36,57,.632,16,32,.500,13,17,.765,133,44,90,.489,32,55,.582,12,35,.343,13,17,.765,113
2019-11-14,NOP,LAC,W 132-127,240,47,98,.480,29,64,.453,18,34,.529,20,29,.690,132,46,84,.548,35,60,.583,11,24,.458,24,31,.774,127
2019-11-18,HOU,POR,W 132-108,240,47,100,.470,30,55,.545,17,45,.378,21,26,.808,132,40,96,.417,29,60,.483,11,36,.306,17,23,.739,108
2019-11-18,TOR,CHO,W 132-96,240,50,97,.515,30,54,.556,20,43,.465,12,15,.800,132,33,78,.423,18,33,.545,15,45,.333,15,24,.625,96
2019-11-20,SAS,WAS,L 132-138,240,49,93,.527,37,61,.607,12,32,.375,22,29,.759,132,54,92,.587,36,62,.581,18,30,.600,12,15,.800,138
2019-11-27,PHO,WAS,L 132-140,240,48,93,.516,33,55,.600,15,38,.395,21,24,.875,132,51,89,.573,32,54,.593,19,35,.543,19,20,.950,140
2019-12-01,DET,SAS,W 132-98,240,52,88,.591,37,57,.649,15,31,.484,13,18,.722,132,36,88,.409,29,62,.468,7,26,.269,19,22,.864,98
2019-12-02,MIL,NYK,W 132-88,240,48,86,.558,32,51,.627,16,35,.457,20,32,.625,132,28,91,.308,18,52,.346,10,39,.256,22,33,.667,88
2019-12-05,NOP,PHO,L 132-139 (OT),265,44,87,.506,27,46,.587,17,41,.415,27,35,.771,132,50,106,.472,36,70,.514,14,36,.389,25,27,.926,139
2019-12-26,DET,WAS,W 132-102,240,46,86,.535,27,38,.711,19,48,.396,21,26,.808,132,38,92,.413,31,68,.456,7,24,.292,19,27,.704,102
2020-01-05,NYK,LAC,L 132-135,240,48,84,.571,36,61,.590,12,23,.522,24,37,.649,132,45,83,.542,27,51,.529,18,32,.563,27,33,.818,135
2020-01-16,UTA,NOP,L 132-138 (OT),265,46,100,.460,31,61,.508,15,39,.385,25,32,.781,132,51,93,.548,40,67,.597,11,26,.423,25,35,.714,138
2019-10-26,MIA,MIL,W 131-126 (OT),265,46,101,.455,30,57,.526,16,44,.364,23,36,.639,131,41,94,.436,24,40,.600,17,54,.315,27,35,.771,126
2019-11-02,MIN,WAS,W 131-109,240,51,94,.543,34,55,.618,17,39,.436,12,17,.706,131,37,95,.389,25,60,.417,12,35,.343,23,27,.852,109
2019-11-03,DAL,CLE,W 131-111,240,50,94,.532,30,53,.566,20,41,.488,11,13,.846,131,39,96,.406,21,48,.438,18,48,.375,15,22,.682,111
2019-11-17,DEN,MEM,W 131-114,240,49,89,.551,31,57,.544,18,32,.563,15,23,.652,131,39,84,.464,23,48,.479,16,36,.444,20,24,.833,114
2020-01-16,GSW,DEN,L 131-134 (OT),265,42,95,.442,22,50,.440,20,45,.444,27,31,.871,131,47,100,.470,30,65,.462,17,35,.486,23,26,.885,134
2019-10-22,TOR,NOP,W 130-122 (OT),265,42,103,.408,28,63,.444,14,40,.350,32,38,.842,130,43,102,.422,24,57,.421,19,45,.422,17,20,.850,122
2019-10-26,PHO,LAC,W 130-122,240,43,86,.500,26,43,.605,17,43,.395,27,34,.794,130,40,87,.460,29,55,.527,11,32,.344,31,39,.795,122
2019-11-22,LAL,OKC,W 130-127,240,45,88,.511,28,57,.491,17,31,.548,23,29,.793,130,49,93,.527,38,62,.613,11,31,.355,18,20,.900,127
2019-12-01,TOR,UTA,W 130-110,240,47,90,.522,28,54,.519,19,36,.528,17,21,.810,130,38,90,.422,25,55,.455,13,35,.371,21,29,.724,110
2019-12-04,BRK,ATL,W 130-118,240,50,101,.495,36,70,.514,14,31,.452,16,18,.889,130,48,90,.533,39,64,.609,9,26,.346,13,21,.619,118
2019-12-07,DAL,NOP,W 130-84,240,46,86,.535,33,48,.688,13,38,.342,25,31,.806,130,32,89,.360,29,57,.509,3,32,.094,17,21,.810,84
2019-12-13,HOU,ORL,W 130-107,240,48,86,.558,26,47,.553,22,39,.564,12,13,.923,130,40,91,.440,25,54,.463,15,37,.405,12,16,.750,107
2019-12-15,ORL,NOP,W 130-119,240,46,89,.517,29,55,.527,17,34,.500,21,26,.808,130,47,88,.534,28,45,.622,19,43,.442,6,12,.500,119
2019-12-31,HOU,DEN,W 130-104,240,46,87,.529,30,53,.566,16,34,.471,22,31,.710,130,45,97,.464,37,72,.514,8,25,.320,6,9,.667,104
2020-01-15,TOR,OKC,W 130-121,240,52,85,.612,37,58,.638,15,27,.556,11,15,.733,130,43,85,.506,27,43,.628,16,42,.381,19,20,.950,121
2019-10-28,MIL,CLE,W 129-112,240,48,92,.522,31,54,.574,17,38,.447,16,24,.667,129,45,100,.450,33,61,.541,12,39,.308,10,12,.833,112
2019-11-02,PHI,POR,W 129-128,240,54,107,.505,43,74,.581,11,33,.333,10,12,.833,129,45,78,.577,26,44,.591,19,34,.559,19,25,.760,128
2019-11-03,MIA,HOU,W 129-100,240,47,89,.528,29,48,.604,18,41,.439,17,22,.773,129,31,79,.392,17,31,.548,14,48,.292,24,31,.774,100
2019-11-06,HOU,GSW,W 129-112,240,48,97,.495,27,52,.519,21,45,.467,12,19,.632,129,38,96,.396,25,63,.397,13,33,.394,23,28,.821,112
2019-11-06,MIL,LAC,W 129-124,240,42,98,.429,24,49,.490,18,49,.367,27,34,.794,129,41,98,.418,28,67,.418,13,31,.419,29,36,.806,124
2019-11-13,MIN,SAS,W 129-114,240,45,91,.495,34,57,.596,11,34,.324,28,34,.824,129,44,90,.489,41,73,.562,3,17,.176,23,29,.793,114
2019-11-21,POR,MIL,L 129-137,240,50,103,.485,33,64,.516,17,39,.436,12,14,.857,129,50,106,.472,34,63,.540,16,43,.372,21,26,.808,137
2019-12-05,DEN,NYK,W 129-92,240,49,87,.563,28,48,.583,21,39,.538,10,18,.556,129,34,83,.410,25,49,.510,9,34,.265,15,23,.652,92
2019-12-20,MIA,NYK,W 129-114,240,43,77,.558,25,39,.641,18,38,.474,25,34,.735,129,41,94,.436,31,60,.517,10,34,.294,22,33,.667,114
2019-12-27,BOS,CLE,W 129-117,240,49,95,.516,35,55,.636,14,40,.350,17,19,.895,129,44,85,.518,35,62,.565,9,23,.391,20,29,.690,117
2020-01-08,SAS,BOS,W 129-114,240,48,87,.552,39,58,.672,9,29,.310,24,26,.923,129,37,89,.416,24,51,.471,13,38,.342,27,30,.900,114
2020-01-10,LAL,DAL,W 129-114,240,47,89,.528,37,65,.569,10,24,.417,25,32,.781,129,39,96,.406,28,58,.483,11,38,.289,25,37,.676,114
2019-11-02,POR,PHI,L 128-129,240,45,78,.577,26,44,.591,19,34,.559,19,25,.760,128,54,107,.505,43,74,.581,11,33,.333,10,12,.833,129
2019-11-14,PHO,ATL,W 128-112,240,41,85,.482,26,46,.565,15,39,.385,31,38,.816,128,40,91,.440,32,60,.533,8,31,.258,24,30,.800,112
2019-11-22,DET,ATL,W 128-103,240,49,82,.598,32,48,.667,17,34,.500,13,20,.650,128,38,88,.432,28,51,.549,10,37,.270,17,17,1.000,103
2019-11-23,UTA,NOP,W 128-120,240,42,82,.512,27,46,.587,15,36,.417,29,33,.879,128,42,101,.416,25,60,.417,17,41,.415,19,20,.950,120
2019-12-04,ORL,PHO,W 128-114,240,49,85,.576,35,60,.583,14,25,.560,16,20,.800,128,43,88,.489,28,55,.509,15,33,.455,13,20,.650,114
2019-12-14,MEM,WAS,W 128-111,240,48,84,.571,37,57,.649,11,27,.407,21,24,.875,128,36,85,.424,22,47,.468,14,38,.368,25,32,.781,111
2019-12-22,DEN,LAL,W 128-104,240,45,92,.489,34,60,.567,11,32,.344,27,30,.900,128,39,83,.470,29,54,.537,10,29,.345,16,22,.727,104
2019-12-28,LAL,POR,W 128-120,240,47,91,.516,36,59,.610,11,32,.344,23,28,.821,128,41,86,.477,26,51,.510,15,35,.429,23,27,.852,120
Date,Tm,Opp,Result,MP,FG_T,FGA_T,FG%_T,2P_T,2PA_T,2P%_T,3P_T,3PA_T,3P%_T,FT_T,FTA_T,FT%_T,PTS_T,FG_O,FGA_O,FG%_O,2P_O,2PA_O,2P%_O,3P_O,3PA_O,3P%_O,FT_O,FTA_O,FT%_O,PTS_O
2020-01-02,SAC,MEM,W 128-123,240,44,90,.489,30,56,.536,14,34,.412,26,31,.839,128,45,93,.484,32,59,.542,13,34,.382,20,21,.952,123
2020-01-04,WAS,DEN,W 128-114,240,50,91,.549,44,75,.587,6,16,.375,22,27,.815,128,40,87,.460,34,58,.586,6,29,.207,28,34,.824,114
2020-01-06,UTA,NOP,W 128-126,240,46,90,.511,30,57,.526,16,33,.485,20,24,.833,128,45,94,.479,33,63,.524,12,31,.387,24,30,.800,126
2020-01-08,UTA,NYK,W 128-104,240,49,90,.544,33,47,.702,16,43,.372,14,23,.609,128,42,97,.433,33,72,.458,9,25,.360,11,11,1.000,104
2020-01-13,LAL,CLE,W 128-99,240,48,88,.545,37,58,.638,11,30,.367,21,28,.750,128,38,85,.447,31,60,.517,7,25,.280,16,24,.667,99
2020-01-14,LAC,CLE,W 128-103,240,49,94,.521,34,56,.607,15,38,.395,15,21,.714,128,38,91,.418,24,54,.444,14,37,.378,13,15,.867,103
2020-01-14,MIL,NYK,W 128-102,240,45,92,.489,30,56,.536,15,36,.417,23,28,.821,128,36,102,.353,25,65,.385,11,37,.297,19,26,.731,102
2020-01-16,MIL,BOS,W 128-123,240,43,87,.494,27,56,.482,16,31,.516,26,37,.703,128,43,98,.439,28,49,.571,15,49,.306,22,27,.815,123
2019-10-23,MIN,BRK,W 127-126 (OT),265,46,108,.426,33,65,.508,13,43,.302,22,28,.786,127,48,101,.475,33,67,.493,15,34,.441,15,26,.577,126
2019-11-01,SAS,GSW,W 127-110,240,44,93,.473,31,58,.534,13,35,.371,26,30,.867,127,39,84,.464,26,56,.464,13,28,.464,19,21,.905,110
2019-11-04,GSW,POR,W 127-118,240,42,86,.488,32,60,.533,10,26,.385,33,36,.917,127,47,105,.448,34,65,.523,13,40,.325,11,14,.786,118
2019-11-14,LAC,NOP,L 127-132,240,46,84,.548,35,60,.583,11,24,.458,24,31,.774,127,47,98,.480,29,64,.453,18,34,.529,20,29,.690,132
2019-11-15,OKC,PHI,W 127-119 (OT),265,41,76,.539,31,52,.596,10,24,.417,35,41,.854,127,45,90,.500,31,58,.534,14,32,.438,15,22,.682,119
2019-11-20,ATL,MIL,L 127-135,240,44,96,.458,30,65,.462,14,31,.452,25,31,.806,127,46,87,.529,29,44,.659,17,43,.395,26,34,.765,135
2019-11-22,OKC,LAL,L 127-130,240,49,93,.527,38,62,.613,11,31,.355,18,20,.900,127,45,88,.511,28,57,.491,17,31,.548,23,29,.793,130
2019-12-03,DET,CLE,W 127-94,240,51,94,.543,33,59,.559,18,35,.514,7,11,.636,127,38,90,.422,30,63,.476,8,27,.296,10,14,.714,94
2019-12-03,ORL,WAS,W 127-120,240,46,90,.511,31,59,.525,15,31,.484,20,27,.741,127,45,89,.506,33,54,.611,12,35,.343,18,23,.783,120
2019-12-04,MIL,DET,W 127-103,240,44,90,.489,30,55,.545,14,35,.400,25,27,.926,127,39,93,.419,28,57,.491,11,36,.306,14,22,.636,103
2019-12-04,POR,SAC,W 127-116,240,47,84,.560,31,52,.596,16,32,.500,17,21,.810,127,44,95,.463,33,61,.541,11,34,.324,17,23,.739,116
2019-12-06,MIN,OKC,L 127-139 (OT),265,50,96,.521,37,58,.638,13,38,.342,14,20,.700,127,49,88,.557,44,70,.629,5,18,.278,36,40,.900,139
2019-12-11,MIL,NOP,W 127-112,240,50,93,.538,31,54,.574,19,39,.487,8,9,.889,127,39,88,.443,23,43,.535,16,45,.356,18,22,.818,112
2019-12-11,UTA,MIN,W 127-116,240,47,83,.566,31,48,.646,16,35,.457,17,22,.773,127,40,91,.440,25,50,.500,15,41,.366,21,26,.808,116
2019-12-13,MIL,MEM,W 127-114,240,44,87,.506,33,57,.579,11,30,.367,28,33,.848,127,38,98,.388,18,49,.367,20,49,.408,18,23,.783,114
2019-12-29,NOP,HOU,W 127-112,240,50,102,.490,32,58,.552,18,44,.409,9,13,.692,127,42,81,.519,27,42,.643,15,39,.385,13,20,.650,112
2020-01-04,MIL,SAS,W 127-118,240,43,87,.494,26,42,.619,17,45,.378,24,33,.727,127,38,92,.413,27,60,.450,11,32,.344,31,34,.912,118
2020-01-10,MIL,SAC,W 127-106,240,47,95,.495,37,56,.661,10,39,.256,23,30,.767,127,44,96,.458,34,61,.557,10,35,.286,8,10,.800,106
2020-01-12,UTA,WAS,W 127-116,240,48,90,.533,38,60,.633,10,30,.333,21,25,.840,127,47,93,.505,40,71,.563,7,22,.318,15,17,.882,116
2020-01-15,DAL,SAC,W 127-123,240,47,92,.511,34,52,.654,13,40,.325,20,24,.833,127,50,96,.521,38,63,.603,12,33,.364,11,20,.550,123
2019-10-23,BRK,MIN,L 126-127 (OT),265,48,101,.475,33,67,.493,15,34,.441,15,26,.577,126,46,108,.426,33,65,.508,13,43,.302,22,28,.786,127
2019-10-23,CHO,CHI,W 126-125,240,45,88,.511,22,44,.500,23,44,.523,13,16,.813,126,49,105,.467,40,75,.533,9,30,.300,18,22,.818,125
2019-10-26,HOU,NOP,W 126-123,240,43,94,.457,30,49,.612,13,45,.289,27,30,.900,126,46,100,.460,28,50,.560,18,50,.360,13,16,.813,123
2019-10-26,MIL,MIA,L 126-131 (OT),265,41,94,.436,24,40,.600,17,54,.315,27,35,.771,126,46,101,.455,30,57,.526,16,44,.364,23,36,.639,131
2019-11-25,IND,MEM,W 126-114,240,51,94,.543,33,61,.541,18,33,.545,6,10,.600,126,46,96,.479,33,67,.493,13,29,.448,9,13,.692,114
2019-11-27,TOR,NYK,W 126-98,240,46,94,.489,25,53,.472,21,41,.512,13,17,.765,126,33,88,.375,21,47,.447,12,41,.293,20,24,.833,98
2019-12-07,UTA,MEM,W 126-112,240,45,80,.563,26,46,.565,19,34,.559,17,18,.944,126,43,81,.531,33,46,.717,10,35,.286,16,25,.640,112
2019-12-18,OKC,MEM,W 126-122,240,46,84,.548,39,60,.650,7,24,.292,27,34,.794,126,50,99,.505,40,73,.548,10,26,.385,12,15,.800,122
2019-12-20,OKC,PHO,W 126-108,240,49,87,.563,39,63,.619,10,24,.417,18,21,.857,126,38,87,.437,27,55,.491,11,32,.344,21,23,.913,108
2020-01-02,LAC,DET,W 126-112,240,50,92,.543,39,64,.609,11,28,.393,15,21,.714,126,40,94,.426,33,61,.541,7,33,.212,25,35,.714,112
2020-01-06,NOP,UTA,L 126-128,240,45,94,.479,33,63,.524,12,31,.387,24,30,.800,126,46,90,.511,30,57,.526,16,33,.485,20,24,.833,128
2020-01-06,SAS,MIL,W 126-104,240,45,88,.511,26,53,.491,19,35,.543,17,19,.895,126,38,95,.400,23,50,.460,15,45,.333,13,14,.929,104
2019-10-23,CHI,CHO,L 125-126,240,49,105,.467,40,75,.533,9,30,.300,18,22,.818,125,45,88,.511,22,44,.500,23,44,.523,13,16,.813,126
2019-10-30,TOR,DET,W 125-113,240,51,86,.593,38,59,.644,13,27,.481,10,12,.833,125,41,88,.466,27,58,.466,14,30,.467,17,23,.739,113
2019-11-04,NOP,BRK,L 125-135,240,48,97,.495,35,65,.538,13,32,.406,16,21,.762,125,49,92,.533,33,51,.647,16,41,.390,21,28,.750,135
2019-11-08,MIN,GSW,W 125-119 (OT),265,48,111,.432,39,75,.520,9,36,.250,20,29,.690,125,43,103,.417,33,68,.485,10,35,.286,23,24,.958,119
2019-11-12,ATL,DEN,W 125-121,240,44,83,.530,29,49,.592,15,34,.441,22,34,.647,125,46,104,.442,35,63,.556,11,41,.268,18,22,.818,121
2019-11-16,HOU,MIN,W 125-105,240,43,94,.457,24,45,.533,19,49,.388,20,22,.909,125,38,84,.452,26,46,.565,12,38,.316,17,23,.739,105
2019-11-17,ORL,WAS,W 125-121,240,43,87,.494,28,49,.571,15,38,.395,24,26,.923,125,46,97,.474,27,56,.482,19,41,.463,10,12,.833,121
2019-11-22,WAS,CHO,W 125-118,240,48,91,.527,34,57,.596,14,34,.412,15,20,.750,125,48,93,.516,34,59,.576,14,34,.412,8,8,1.000,118
2019-11-25,MIN,ATL,W 125-113,240,41,90,.456,26,55,.473,15,35,.429,28,36,.778,125,41,94,.436,31,62,.500,10,32,.313,21,26,.808,113
2019-11-29,LAL,WAS,W 125-103,240,45,87,.517,31,55,.564,14,32,.438,21,28,.750,125,38,96,.396,28,59,.475,10,37,.270,17,19,.895,103
2019-12-01,WAS,LAC,L 125-150,240,47,102,.461,36,72,.500,11,30,.367,20,27,.741,125,52,94,.553,38,62,.613,14,32,.438,32,40,.800,150
2019-12-08,MIN,LAL,L 125-142,240,44,84,.524,29,47,.617,15,37,.405,22,26,.846,125,55,94,.585,41,63,.651,14,31,.452,18,20,.900,142
2019-12-09,PHO,MIN,W 125-109,240,47,95,.495,31,55,.564,16,40,.400,15,19,.789,125,40,85,.471,34,63,.540,6,22,.273,23,29,.793,109
2019-12-14,MIL,CLE,W 125-108,240,46,85,.541,32,48,.667,14,37,.378,19,26,.731,125,41,90,.456,26,55,.473,15,35,.429,11,15,.733,108
2019-12-21,PHI,WAS,W 125-108,240,49,94,.521,35,61,.574,14,33,.424,13,21,.619,125,36,88,.409,29,57,.509,7,31,.226,29,34,.853,108
2019-12-21,PHO,HOU,L 125-139,240,47,91,.516,39,63,.619,8,28,.286,23,30,.767,125,51,87,.586,32,46,.696,19,41,.463,18,23,.783,139
2019-12-23,PHI,DET,W 125-109,240,52,95,.547,40,65,.615,12,30,.400,9,11,.818,125,43,84,.512,33,54,.611,10,30,.333,13,18,.722,109
2020-01-11,LAL,OKC,W 125-110,240,51,99,.515,36,67,.537,15,32,.469,8,10,.800,125,43,92,.467,34,61,.557,9,31,.290,15,17,.882,110
2019-10-23,PHO,SAC,W 124-95,240,49,98,.500,38,65,.585,11,33,.333,15,18,.833,124,34,87,.391,24,58,.414,10,29,.345,17,26,.654,95
2019-10-26,SAS,WAS,W 124-122,240,50,108,.463,40,80,.500,10,28,.357,14,17,.824,124,47,95,.495,31,61,.508,16,34,.471,12,17,.706,122
2019-11-06,LAC,MIL,L 124-129,240,41,98,.418,28,67,.418,13,31,.419,29,36,.806,124,42,98,.429,24,49,.490,18,49,.367,27,34,.794,129
2019-11-06,TOR,SAC,W 124-120,240,43,78,.551,29,49,.592,14,29,.483,24,29,.828,124,42,95,.442,22,51,.431,20,44,.455,16,21,.762,120
2019-11-07,MIA,PHO,W 124-108,240,45,82,.549,30,54,.556,15,28,.536,19,24,.792,124,37,84,.440,26,52,.500,11,32,.344,23,31,.742,108
2019-11-10,POR,ATL,W 124-113 (OT),265,45,104,.433,33,68,.485,12,36,.333,22,28,.786,124,42,104,.404,31,63,.492,11,41,.268,18,25,.720,113
2019-11-14,MIL,CHI,W 124-115,240,42,88,.477,36,55,.655,6,33,.182,34,47,.723,124,38,93,.409,20,50,.400,18,43,.419,21,25,.840,115
2019-11-20,MIA,CLE,W 124-100,240,41,78,.526,22,41,.537,19,37,.514,23,31,.742,124,37,87,.425,25,49,.510,12,38,.316,14,16,.875,100
2019-11-21,NOP,PHO,W 124-121,240,47,88,.534,31,53,.585,16,35,.457,14,22,.636,124,40,86,.465,27,55,.491,13,31,.419,28,32,.875,121
2019-12-11,NYK,GSW,W 124-122 (OT),265,43,90,.478,31,61,.508,12,29,.414,26,34,.765,124,45,104,.433,35,67,.522,10,37,.270,22,30,.733,122
2019-12-13,LAC,MIN,W 124-117,240,39,79,.494,28,54,.519,11,25,.440,35,39,.897,124,38,85,.447,28,44,.636,10,41,.244,31,37,.838,117
2020-01-02,DEN,IND,W 124-116,240,46,87,.529,38,60,.633,8,27,.296,24,27,.889,124,43,82,.524,31,56,.554,12,26,.462,18,25,.720,116
2020-01-12,NYK,MIA,W 124-121,240,46,90,.511,37,59,.627,9,31,.290,23,28,.821,124,42,78,.538,28,43,.651,14,35,.400,23,28,.821,121
2020-01-14,DAL,GSW,W 124-97,240,49,96,.510,36,59,.610,13,37,.351,13,21,.619,124,39,87,.448,30,55,.545,9,32,.281,10,13,.769,97
2019-10-25,DAL,NOP,W 123-116,240,45,93,.484,31,53,.585,14,40,.350,19,26,.731,123,45,98,.459,30,57,.526,15,41,.366,11,15,.733,116
2019-10-26,NOP,HOU,L 123-126,240,46,100,.460,28,50,.560,18,50,.360,13,16,.813,123,43,94,.457,30,49,.612,13,45,.289,27,30,.900,126
2019-10-28,NOP,GSW,L 123-134,240,48,103,.466,33,56,.589,15,47,.319,12,22,.545,123,51,104,.490,37,69,.536,14,35,.400,18,24,.750,134
2019-11-01,BRK,HOU,W 123-116,240,42,85,.494,23,53,.434,19,32,.594,20,28,.714,123,41,99,.414,29,51,.569,12,48,.250,22,27,.815,116
2019-11-01,MIL,ORL,W 123-91,240,47,93,.505,30,46,.652,17,47,.362,12,18,.667,123,34,91,.374,22,54,.407,12,37,.324,11,17,.647,91
2019-11-12,LAL,PHO,W 123-115,240,51,95,.537,41,70,.586,10,25,.400,11,21,.524,123,43,91,.473,27,53,.509,16,38,.421,13,17,.765,115
2019-11-18,NYK,CLE,W 123-105,240,44,98,.449,36,75,.480,8,23,.348,27,35,.771,123,36,76,.474,19,40,.475,17,36,.472,16,30,.533,105
2019-11-24,HOU,DAL,L 123-137,240,45,98,.459,35,54,.648,10,44,.227,23,31,.742,123,49,102,.480,32,58,.552,17,44,.386,22,28,.786,137
2019-12-21,MIL,NYK,W 123-102,240,41,85,.482,23,42,.548,18,43,.419,23,35,.657,123,39,97,.402,30,67,.448,9,30,.300,15,21,.714,102
2019-12-30,MIL,CHI,W 123-102,240,46,84,.548,35,52,.673,11,32,.344,20,24,.833,123,40,107,.374,23,63,.365,17,44,.386,5,8,.625,102
2019-12-30,WAS,MIA,W 123-105,240,43,84,.512,26,47,.553,17,37,.459,20,30,.667,123,33,73,.452,23,45,.511,10,28,.357,29,39,.744,105
2020-01-02,DAL,BRK,W 123-111,240,45,89,.506,27,51,.529,18,38,.474,15,17,.882,123,42,91,.462,30,54,.556,12,37,.324,15,17,.882,111
2020-01-02,MEM,SAC,L 123-128,240,45,93,.484,32,59,.542,13,34,.382,20,21,.952,123,44,90,.489,30,56,.536,14,34,.412,26,31,.839,128
2020-01-03,LAL,NOP,W 123-113,240,43,86,.500,29,57,.509,14,29,.483,23,28,.821,123,48,102,.471,37,65,.569,11,37,.297,6,7,.857,113
2020-01-04,CHO,DAL,W 123-120 (OT),265,42,85,.494,31,60,.517,11,25,.440,28,31,.903,123,47,100,.470,32,50,.640,15,50,.300,11,13,.846,120
2020-01-06,DEN,ATL,W 123-115,240,47,92,.511,38,65,.585,9,27,.333,20,27,.741,123,35,77,.455,17,38,.447,18,39,.462,27,32,.844,115
2020-01-08,NOP,CHI,W 123-108,240,41,87,.471,26,43,.605,15,44,.341,26,32,.813,123,41,92,.446,27,57,.474,14,35,.400,12,21,.571,108
2020-01-08,ORL,WAS,W 123-89,240,43,87,.494,33,60,.550,10,27,.370,27,34,.794,123,36,84,.429,30,61,.492,6,23,.261,11,19,.579,89
2020-01-10,NOP,NYK,W 123-111,240,48,86,.558,30,48,.625,18,38,.474,9,17,.529,123,46,100,.460,41,73,.562,5,27,.185,14,20,.700,111
2020-01-14,ATL,PHO,W 123-110,240,46,93,.495,32,62,.516,14,31,.452,17,20,.850,123,40,87,.460,36,67,.537,4,20,.200,26,32,.813,110
2020-01-15,SAC,DAL,L 123-127,240,50,96,.521,38,63,.603,12,33,.364,11,20,.550,123,47,92,.511,34,52,.654,13,40,.325,20,24,.833,127
2020-01-16,BOS,MIL,L 123-128,240,43,98,.439,28,49,.571,15,49,.306,22,27,.815,123,43,87,.494,27,56,.482,16,31,.516,26,37,.703,128
2019-10-22,NOP,TOR,L 122-130 (OT),265,43,102,.422,24,57,.421,19,45,.422,17,20,.850,122,42,103,.408,28,63,.444,14,40,.350,32,38,.842,130
2019-10-24,GSW,LAC,L 122-141,240,39,99,.394,24,57,.421,15,42,.357,29,30,.967,122,50,80,.625,32,48,.667,18,32,.563,23,30,.767,141
2019-10-25,POR,SAC,W 122-112,240,46,85,.541,35,55,.636,11,30,.367,19,22,.864,122,37,87,.425,22,50,.440,15,37,.405,23,27,.852,112
2019-10-26,LAC,PHO,L 122-130,240,40,87,.460,29,55,.527,11,32,.344,31,39,.795,122,43,86,.500,26,43,.605,17,43,.395,27,34,.794,130
2019-10-26,WAS,SAS,L 122-124,240,47,95,.495,31,61,.508,16,34,.471,12,17,.706,122,50,108,.463,40,80,.500,10,28,.357,14,17,.824,124
2019-10-31,NOP,DEN,W 122-107,240,41,77,.532,26,44,.591,15,33,.455,25,32,.781,122,43,89,.483,36,63,.571,7,26,.269,14,16,.875,107
Date,Tm,Opp,Result,MP,FG_T,FGA_T,FG%_T,2P_T,2PA_T,2P%_T,3P_T,3PA_T,3P%_T,FT_T,FTA_T,FT%_T,PTS_T,FG_O,FGA_O,FG%_O,2P_O,2PA_O,2P%_O,3P_O,3PA_O,3P%_O,FT_O,FTA_O,FT%_O,PTS_O
2019-11-05,CHO,IND,W 122-120 (OT),265,42,88,.477,32,57,.561,10,31,.323,28,42,.667,122,51,94,.543,39,64,.609,12,30,.400,6,7,.857,120
2019-11-06,DET,NYK,W 122-102,240,44,79,.557,29,49,.592,15,30,.500,19,24,.792,122,39,80,.488,28,55,.509,11,25,.440,13,21,.619,102
2019-11-08,TOR,NOP,W 122-104,240,41,93,.441,22,50,.440,19,43,.442,21,24,.875,122,40,99,.404,30,58,.517,10,41,.244,14,21,.667,104
2019-11-09,MEM,DAL,L 122-138,240,50,95,.526,38,59,.644,12,36,.333,10,14,.714,122,52,97,.536,34,55,.618,18,42,.429,16,20,.800,138
2019-11-11,UTA,GSW,W 122-108,240,40,81,.494,24,46,.522,16,35,.457,26,32,.813,122,45,94,.479,35,63,.556,10,31,.323,8,14,.571,108
2019-11-11,HOU,NOP,W 122-116,240,44,85,.518,32,44,.727,12,41,.293,22,32,.688,122,41,95,.432,27,50,.540,14,45,.311,20,27,.741,116
2019-11-17,LAL,ATL,W 122-101,240,47,89,.528,32,54,.593,15,35,.429,13,16,.813,122,37,86,.430,29,58,.500,8,28,.286,19,25,.760,101
2019-11-22,LAC,HOU,W 122-119,240,45,87,.517,32,54,.593,13,33,.394,19,24,.792,122,39,84,.464,24,41,.585,15,43,.349,26,38,.684,119
2019-11-25,MIL,UTA,W 122-118,240,43,97,.443,30,56,.536,13,41,.317,23,29,.793,122,43,85,.506,22,40,.550,21,45,.467,11,12,.917,118
2019-11-29,MIA,GSW,W 122-105,240,44,82,.537,31,57,.544,13,25,.520,21,28,.750,122,30,77,.390,20,49,.408,10,28,.357,35,40,.875,105
2019-12-08,ATL,CHO,W 122-107,240,44,91,.484,26,46,.565,18,45,.400,16,17,.941,122,36,90,.400,25,59,.424,11,31,.355,24,29,.828,107
2019-12-11,GSW,NYK,L 122-124 (OT),265,45,104,.433,35,67,.522,10,37,.270,22,30,.733,122,43,90,.478,31,61,.508,12,29,.414,26,34,.765,124
2019-12-11,IND,BOS,W 122-117,240,41,85,.482,31,60,.517,10,25,.400,30,36,.833,122,43,87,.494,29,51,.569,14,36,.389,17,22,.773,117
2019-12-12,DAL,DET,W 122-111,240,45,88,.511,29,44,.659,16,44,.364,16,23,.696,122,40,89,.449,25,47,.532,15,42,.357,16,23,.696,111
2019-12-14,MIA,DAL,W 122-118 (OT),265,39,91,.429,23,51,.451,16,40,.400,28,34,.824,122,45,101,.446,28,57,.491,17,44,.386,11,17,.647,118
2019-12-18,MEM,OKC,L 122-126,240,50,99,.505,40,73,.548,10,26,.385,12,15,.800,122,46,84,.548,39,60,.650,7,24,.292,27,34,.794,126
2019-12-18,POR,GSW,W 122-112,240,44,97,.454,35,66,.530,9,31,.290,25,28,.893,122,41,103,.398,25,65,.385,16,38,.421,14,23,.609,112
2019-12-19,HOU,LAC,W 122-117,240,43,86,.500,29,49,.592,14,37,.378,22,29,.759,122,43,86,.500,27,49,.551,16,37,.432,15,19,.789,117
2019-12-20,TOR,WAS,W 122-118,240,38,78,.487,26,48,.542,12,30,.400,34,44,.773,122,40,87,.460,26,48,.542,14,39,.359,24,32,.750,118
2019-12-21,BRK,ATL,W 122-112,240,46,100,.460,35,70,.500,11,30,.367,19,28,.679,122,39,105,.371,28,57,.491,11,48,.229,23,27,.852,112
2019-12-30,MIN,BRK,W 122-115 (OT),265,42,104,.404,25,60,.417,17,44,.386,21,29,.724,122,40,99,.404,25,58,.431,15,41,.366,20,27,.741,115
2019-12-30,PHO,POR,W 122-116,240,44,92,.478,31,69,.449,13,23,.565,21,22,.955,122,44,96,.458,30,62,.484,14,34,.412,14,18,.778,116
2020-01-01,ORL,WAS,W 122-101,240,45,95,.474,33,63,.524,12,32,.375,20,27,.741,122,33,87,.379,24,56,.429,9,31,.290,26,31,.839,101
2020-01-03,POR,WAS,W 122-103,240,45,88,.511,39,63,.619,6,25,.240,26,33,.788,122,38,90,.422,27,57,.474,11,33,.333,16,25,.640,103
2020-01-05,MIA,POR,W 122-111,240,47,90,.522,29,46,.630,18,44,.409,10,16,.625,122,40,87,.460,27,50,.540,13,37,.351,18,20,.900,111
2020-01-08,HOU,ATL,W 122-115,240,39,92,.424,26,47,.553,13,45,.289,31,41,.756,122,39,106,.368,26,62,.419,13,44,.295,24,27,.889,115
2020-01-08,MIA,IND,W 122-108,240,43,81,.531,27,43,.628,16,38,.421,20,25,.800,122,40,84,.476,31,57,.544,9,27,.333,19,25,.760,108
2020-01-11,MIL,POR,W 122-101,240,47,103,.456,33,65,.508,14,38,.368,14,20,.700,122,37,95,.389,27,59,.458,10,36,.278,17,21,.810,101
2020-01-12,MEM,GSW,W 122-102,240,45,100,.450,34,65,.523,11,35,.314,21,25,.840,122,35,92,.380,18,58,.310,17,34,.500,15,21,.714,102
2020-01-16,LAC,ORL,W 122-95,240,47,95,.495,33,63,.524,14,32,.438,14,20,.700,122,36,92,.391,22,50,.440,14,42,.333,9,16,.563,95
2019-10-25,MIN,CHO,W 121-99,240,43,91,.473,31,53,.585,12,38,.316,23,31,.742,121,37,84,.440,25,55,.455,12,29,.414,13,26,.500,99
2019-10-27,POR,DAL,W 121-119,240,45,87,.517,36,65,.554,9,22,.409,22,26,.846,121,37,94,.394,24,44,.545,13,50,.260,32,41,.780,119
2019-10-30,PHO,GSW,W 121-110,240,44,96,.458,29,60,.483,15,36,.417,18,21,.857,121,36,82,.439,28,54,.519,8,28,.286,30,36,.833,110
2019-11-06,IND,WAS,W 121-106,240,44,94,.468,32,64,.500,12,30,.400,21,26,.808,121,37,95,.389,24,55,.436,13,40,.325,19,19,1.000,106
2019-11-06,MIN,MEM,L 121-137,240,43,96,.448,27,51,.529,16,45,.356,19,26,.731,121,50,88,.568,38,65,.585,12,23,.522,25,30,.833,137
2019-11-07,SAS,OKC,W 121-112,240,51,94,.543,42,74,.568,9,20,.450,10,11,.909,121,42,80,.525,32,59,.542,10,21,.476,18,24,.750,112
2019-11-08,SAC,ATL,W 121-109,240,42,76,.553,24,45,.533,18,31,.581,19,22,.864,121,46,87,.529,37,59,.627,9,28,.321,8,14,.571,109
2019-11-10,MIL,OKC,W 121-119,240,47,83,.566,36,55,.655,11,28,.393,16,18,.889,121,45,91,.495,28,49,.571,17,42,.405,12,17,.706,119
2019-11-12,DEN,ATL,L 121-125,240,46,104,.442,35,63,.556,11,41,.268,18,22,.818,121,44,83,.530,29,49,.592,15,34,.441,22,34,.647,125
2019-11-16,POR,SAS,W 121-116,240,42,93,.452,29,54,.537,13,39,.333,24,26,.923,121,41,88,.466,36,70,.514,5,18,.278,29,34,.853,116
2019-11-17,WAS,ORL,L 121-125,240,46,97,.474,27,56,.482,19,41,.463,10,12,.833,121,43,87,.494,28,49,.571,15,38,.395,24,26,.923,125
2019-11-21,PHO,NOP,L 121-124,240,40,86,.465,27,55,.491,13,31,.419,28,32,.875,121,47,88,.534,31,53,.585,16,35,.457,14,22,.636,124
2019-11-27,BOS,BRK,W 121-110,240,43,97,.443,30,63,.476,13,34,.382,22,24,.917,121,40,90,.444,19,34,.559,21,56,.375,9,19,.474,110
2019-11-27,IND,UTA,W 121-102,240,50,96,.521,42,74,.568,8,22,.364,13,16,.813,121,36,83,.434,26,51,.510,10,32,.313,20,25,.800,102
2019-11-27,LAC,MEM,W 121-119,240,44,95,.463,30,54,.556,14,41,.341,19,25,.760,121,43,92,.467,32,64,.500,11,28,.393,22,26,.846,119
2019-12-03,MIA,TOR,W 121-110 (OT),265,45,99,.455,30,61,.492,15,38,.395,16,21,.762,121,35,91,.385,24,48,.500,11,43,.256,29,36,.806,110
2019-12-04,DAL,MIN,W 121-114,240,46,92,.500,35,55,.636,11,37,.297,18,23,.783,121,37,89,.416,20,51,.392,17,38,.447,23,26,.885,114
2019-12-04,LAL,UTA,W 121-96,240,46,90,.511,32,61,.525,14,29,.483,15,25,.600,121,34,83,.410,20,52,.385,14,31,.452,14,19,.737,96
2019-12-10,ATL,MIA,L 121-135 (OT),265,45,95,.474,25,41,.610,20,54,.370,11,18,.611,121,53,103,.515,39,62,.629,14,41,.341,15,22,.682,135
2019-12-14,SAS,PHO,W 121-119 (OT),265,44,106,.415,36,76,.474,8,30,.267,25,34,.735,121,45,103,.437,35,63,.556,10,40,.250,19,26,.731,119
2019-12-23,CLE,ATL,W 121-118,240,50,96,.521,39,67,.582,11,29,.379,10,12,.833,121,45,95,.474,30,53,.566,15,42,.357,13,17,.765,118
2019-12-23,WAS,NYK,W 121-115,240,47,100,.470,37,70,.529,10,30,.333,17,30,.567,121,44,93,.473,29,57,.509,15,36,.417,12,15,.800,115
2019-12-25,PHI,MIL,W 121-109,240,44,101,.436,23,57,.404,21,44,.477,12,15,.800,121,45,95,.474,32,62,.516,13,33,.394,6,8,.750,109
2019-12-26,UTA,POR,W 121-115,240,46,81,.568,32,45,.711,14,36,.389,15,22,.682,121,43,89,.483,28,55,.509,15,34,.441,14,19,.737,115
2019-12-28,GSW,DAL,L 121-141,240,45,93,.484,27,54,.500,18,39,.462,13,17,.765,121,48,92,.522,24,41,.585,24,51,.471,21,21,1.000,141
2020-01-04,TOR,BRK,W 121-102,240,44,97,.454,31,65,.477,13,32,.406,20,28,.714,121,32,67,.478,19,32,.594,13,35,.371,25,34,.735,102
2020-01-04,OKC,CLE,W 121-106,240,43,96,.448,29,59,.492,14,37,.378,21,26,.808,121,39,85,.459,25,55,.455,14,30,.467,14,17,.824,106
2020-01-05,MEM,PHO,W 121-114,240,45,83,.542,27,41,.659,18,42,.429,13,17,.765,121,43,95,.453,37,69,.536,6,26,.231,22,26,.846,114
2020-01-10,SAS,MEM,L 121-134,240,42,87,.483,25,47,.532,17,40,.425,20,23,.870,121,52,100,.520,36,62,.581,16,38,.421,14,16,.875,134
2020-01-12,MIA,NYK,L 121-124,240,42,78,.538,28,43,.651,14,35,.400,23,28,.821,121,46,90,.511,37,59,.627,9,31,.290,23,28,.821,124
2020-01-14,MEM,HOU,W 121-110,240,46,91,.505,33,54,.611,13,37,.351,16,19,.842,121,37,86,.430,23,41,.561,14,45,.311,22,24,.917,110
2020-01-15,OKC,TOR,L 121-130,240,43,85,.506,27,43,.628,16,42,.381,19,20,.950,121,52,85,.612,37,58,.638,15,27,.556,11,15,.733,130
2020-01-16,PHO,NYK,W 121-98,240,47,92,.511,35,62,.565,12,30,.400,15,18,.833,121,37,90,.411,29,64,.453,8,26,.308,16,24,.667,98
2020-01-17,ATL,SAS,W 121-120,240,41,82,.500,22,42,.524,19,40,.475,20,27,.741,121,45,98,.459,37,69,.536,8,29,.276,22,23,.957,120
2019-10-23,MIA,MEM,W 120-101,240,40,85,.471,33,67,.493,7,18,.389,33,39,.846,120,38,89,.427,33,57,.579,5,32,.156,20,30,.667,101
2019-10-23,SAS,NYK,W 120-111,240,42,83,.506,35,62,.565,7,21,.333,29,36,.806,120,44,94,.468,34,64,.531,10,30,.333,13,18,.722,111
2019-10-27,LAL,CHO,W 120-101,240,49,93,.527,38,62,.613,11,31,.355,11,14,.786,120,35,91,.385,25,56,.446,10,35,.286,21,23,.913,101
2019-10-27,OKC,GSW,W 120-92,240,44,78,.564,29,46,.630,15,32,.469,17,22,.773,120,30,92,.326,25,59,.424,5,33,.152,27,31,.871,92
2019-10-29,LAL,MEM,W 120-91,240,40,86,.465,33,60,.550,7,26,.269,33,39,.846,120,31,95,.326,24,61,.393,7,34,.206,22,23,.957,91
2019-11-05,IND,CHO,L 120-122 (OT),265,51,94,.543,39,64,.609,12,30,.400,6,7,.857,120,42,88,.477,32,57,.561,10,31,.323,28,42,.667,122
2019-11-06,SAC,TOR,L 120-124,240,42,95,.442,22,51,.431,20,44,.455,16,21,.762,120,43,78,.551,29,49,.592,14,29,.483,24,29,.828,124
2019-11-11,MIN,DET,W 120-114,240,45,89,.506,30,55,.545,15,34,.441,15,19,.789,120,39,87,.448,23,55,.418,16,32,.500,20,25,.800,114
2019-11-12,CHI,NYK,W 120-102,240,41,81,.506,27,48,.563,14,33,.424,24,31,.774,120,36,88,.409,26,56,.464,10,32,.313,20,31,.645,102
2019-11-13,LAL,GSW,W 120-94,240,48,89,.539,39,69,.565,9,20,.450,15,18,.833,120,36,89,.404,27,54,.500,9,35,.257,13,17,.765,94
2019-11-19,SAC,PHO,W 120-116,240,42,79,.532,29,48,.604,13,31,.419,23,25,.920,120,38,89,.427,26,53,.491,12,36,.333,28,34,.824,116
2019-11-23,NOP,UTA,L 120-128,240,42,101,.416,25,60,.417,17,41,.415,19,20,.950,120,42,82,.512,27,46,.587,15,36,.417,29,33,.879,128
2019-11-29,DAL,PHO,W 120-113,240,35,85,.412,18,38,.474,17,47,.362,33,38,.868,120,41,93,.441,28,55,.509,13,38,.342,18,25,.720,113
2019-12-03,WAS,ORL,L 120-127,240,45,89,.506,33,54,.611,12,35,.343,18,23,.783,120,46,90,.511,31,59,.525,15,31,.484,20,27,.741,127
2019-12-16,DAL,MIL,W 120-116,240,41,88,.466,25,47,.532,16,41,.390,22,27,.815,120,44,105,.419,33,64,.516,11,41,.268,17,24,.708,116
2019-12-17,LAC,PHO,W 120-99,240,45,89,.506,31,57,.544,14,32,.438,16,22,.727,120,41,102,.402,31,67,.463,10,35,.286,7,10,.700,99
2019-12-17,ATL,NYK,L 120-143,240,45,99,.455,30,56,.536,15,43,.349,15,20,.750,120,53,95,.558,40,67,.597,13,28,.464,24,31,.774,143
2019-12-23,IND,TOR,W 120-115 (OT),265,45,95,.474,27,53,.509,18,42,.429,12,20,.600,120,43,94,.457,32,54,.593,11,40,.275,18,24,.750,115
2019-12-28,UTA,LAC,W 120-107,240,45,86,.523,28,51,.549,17,35,.486,13,17,.765,120,35,95,.368,23,55,.418,12,40,.300,25,27,.926,107
2019-12-28,NOP,IND,W 120-98,240,43,93,.462,25,51,.490,18,42,.429,16,20,.800,120,33,85,.388,27,57,.474,6,28,.214,26,29,.897,98
2019-12-28,POR,LAL,L 120-128,240,41,86,.477,26,51,.510,15,35,.429,23,27,.852,120,47,91,.516,36,59,.610,11,32,.344,23,28,.821,128
2019-12-29,DEN,SAC,W 120-115,240,42,81,.519,34,52,.654,8,29,.276,28,31,.903,120,45,85,.529,32,51,.627,13,34,.382,12,17,.706,115
2020-01-03,PHO,NYK,W 120-112,240,42,90,.467,32,62,.516,10,28,.357,26,33,.788,120,41,92,.446,31,55,.564,10,37,.270,20,30,.667,112
2020-01-04,DAL,CHO,L 120-123 (OT),265,47,100,.470,32,50,.640,15,50,.300,11,13,.846,120,42,85,.494,31,60,.517,11,25,.440,28,31,.903,123
2020-01-06,PHI,OKC,W 120-113,240,46,90,.511,33,64,.516,13,26,.500,15,18,.833,120,40,89,.449,28,60,.467,12,29,.414,21,31,.677,113
2020-01-17,DAL,POR,W 120-112,240,39,89,.438,19,42,.452,20,47,.426,22,28,.786,120,44,85,.518,35,55,.636,9,30,.300,15,22,.682,112
2020-01-17,SAS,ATL,L 120-121,240,45,98,.459,37,69,.536,8,29,.276,22,23,.957,120,41,82,.500,22,42,.524,19,40,.475,20,27,.741,121
2019-10-23,DET,IND,W 119-110,240,41,78,.526,30,54,.556,11,24,.458,26,33,.788,119,41,89,.461,33,68,.485,8,21,.381,20,24,.833,110
2019-10-27,DAL,POR,L 119-121,240,37,94,.394,24,44,.545,13,50,.260,32,41,.780,119,45,87,.517,36,65,.554,9,22,.409,22,26,.846,121
2019-11-01,LAL,DAL,W 119-110 (OT),265,47,96,.490,38,64,.594,9,32,.281,16,21,.762,119,40,102,.392,26,66,.394,14,36,.389,16,23,.696,110
2019-11-05,BOS,CLE,W 119-113,240,48,85,.565,36,55,.655,12,30,.400,11,15,.733,119,40,95,.421,27,62,.435,13,33,.394,20,22,.909,113
2019-11-08,GSW,MIN,L 119-125 (OT),265,43,103,.417,33,68,.485,10,35,.286,23,24,.958,119,48,111,.432,39,75,.520,9,36,.250,20,29,.690,125
2019-11-08,BRK,POR,W 119-115,240,41,99,.414,25,62,.403,16,37,.432,21,30,.700,119,40,97,.412,29,67,.433,11,30,.367,24,25,.960,115
2019-11-10,OKC,MIL,L 119-121,240,45,91,.495,28,49,.571,17,42,.405,12,17,.706,119,47,83,.566,36,55,.655,11,28,.393,16,18,.889,121
2019-11-12,UTA,BRK,W 119-114,240,43,92,.467,37,66,.561,6,26,.231,27,35,.771,119,41,90,.456,30,53,.566,11,37,.297,21,25,.840,114
2019-11-13,MEM,CHO,W 119-117,240,48,89,.539,31,54,.574,17,35,.486,6,9,.667,119,43,87,.494,27,51,.529,16,36,.444,15,19,.789,117
Date,Tm,Opp,Result,MP,FG_T,FGA_T,FG%_T,2P_T,2PA_T,2P%_T,3P_T,3PA_T,3P%_T,FT_T,FTA_T,FT%_T,PTS_T,FG_O,FGA_O,FG%_O,2P_O,2PA_O,2P%_O,3P_O,3PA_O,3P%_O,FT_O,FTA_O,FT%_O,PTS_O
2019-11-15,PHI,OKC,L 119-127 (OT),265,45,90,.500,31,58,.534,14,32,.438,15,22,.682,119,41,76,.539,31,52,.596,10,24,.417,35,41,.854,127
2019-11-22,HOU,LAC,L 119-122,240,39,84,.464,24,41,.585,15,43,.349,26,38,.684,119,45,87,.517,32,54,.593,13,33,.394,19,24,.792,122
2019-11-23,TOR,ATL,W 119-116,240,40,88,.455,27,51,.529,13,37,.351,26,30,.867,119,47,90,.522,33,56,.589,14,34,.412,8,11,.727,116
2019-11-27,MEM,LAC,L 119-121,240,43,92,.467,32,64,.500,11,28,.393,22,26,.846,119,44,95,.463,30,54,.556,14,41,.341,19,25,.760,121
2019-11-27,OKC,POR,L 119-136,240,39,88,.443,28,53,.528,11,35,.314,30,38,.789,119,49,94,.521,35,64,.547,14,30,.467,24,24,1.000,136
2019-11-29,MIL,CLE,W 119-110,240,45,88,.511,33,54,.611,12,34,.353,17,23,.739,119,44,88,.500,27,54,.500,17,34,.500,5,10,.500,110
2019-11-30,PHI,IND,W 119-116,240,38,77,.494,27,54,.500,11,23,.478,32,36,.889,119,42,76,.553,31,54,.574,11,22,.500,21,25,.840,116
2019-12-05,HOU,TOR,W 119-109,240,40,98,.408,18,43,.419,22,55,.400,17,19,.895,119,38,88,.432,26,49,.531,12,39,.308,21,24,.875,109
2019-12-05,WAS,PHI,W 119-113,240,41,90,.456,30,63,.476,11,27,.407,26,32,.813,119,41,77,.532,28,49,.571,13,28,.464,18,24,.750,113
2019-12-06,MIL,LAC,W 119-91,240,44,94,.468,30,58,.517,14,36,.389,17,21,.810,119,33,94,.351,25,62,.403,8,32,.250,17,19,.895,91
2019-12-08,WAS,LAC,L 119-135,240,40,88,.455,26,55,.473,14,33,.424,25,30,.833,119,50,96,.521,35,56,.625,15,40,.375,20,27,.741,135
2019-12-09,SAC,HOU,W 119-118,240,40,88,.455,20,43,.465,20,45,.444,19,22,.864,119,41,84,.488,24,34,.706,17,50,.340,19,23,.826,118
2019-12-14,PHO,SAS,L 119-121 (OT),265,45,103,.437,35,63,.556,10,40,.250,19,26,.731,119,44,106,.415,36,76,.474,8,30,.267,25,34,.735,121
2019-12-15,NOP,ORL,L 119-130,240,47,88,.534,28,45,.622,19,43,.442,6,12,.500,119,46,89,.517,29,55,.527,17,34,.500,21,26,.808,130
2019-12-16,DET,WAS,L 119-133,240,41,86,.477,28,47,.596,13,39,.333,24,34,.706,119,49,88,.557,31,54,.574,18,34,.529,17,21,.810,133
2019-12-20,IND,SAC,W 119-105,240,45,86,.523,31,55,.564,14,31,.452,15,18,.833,119,41,91,.451,31,59,.525,10,32,.313,13,15,.867,105
2019-12-21,CHI,DET,W 119-107,240,40,77,.519,22,42,.524,18,35,.514,21,25,.840,119,40,87,.460,24,52,.462,16,35,.457,11,12,.917,107
2019-12-21,MEM,SAC,W 119-115,240,40,83,.482,25,48,.521,15,35,.429,24,29,.828,119,43,100,.430,32,64,.500,11,36,.306,18,24,.750,115
2019-12-22,BOS,CHO,W 119-93,240,46,88,.523,32,56,.571,14,32,.438,13,16,.813,119,33,82,.402,23,48,.479,10,34,.294,17,23,.739,93
2019-12-28,DEN,MEM,W 119-110,240,45,93,.484,36,64,.563,9,29,.310,20,27,.741,119,41,84,.488,32,54,.593,9,30,.300,19,25,.760,110
2020-01-07,MEM,MIN,W 119-112,240,46,89,.517,38,61,.623,8,28,.286,19,21,.905,119,40,90,.444,25,43,.581,15,47,.319,17,21,.810,112
2020-01-15,ORL,LAL,W 119-118,240,43,94,.457,33,68,.485,10,26,.385,23,29,.793,119,48,97,.495,33,59,.559,15,38,.395,7,11,.636,118
2019-10-26,BOS,NYK,W 118-95,240,42,93,.452,27,52,.519,15,41,.366,19,29,.655,118,31,82,.378,24,55,.436,7,27,.259,26,34,.765,95
2019-10-30,IND,BRK,W 118-108,240,45,96,.469,34,70,.486,11,26,.423,17,20,.850,118,41,93,.441,31,62,.500,10,31,.323,16,26,.615,108
2019-10-30,CHO,SAC,W 118-111,240,46,84,.548,30,52,.577,16,32,.500,10,14,.714,118,44,96,.458,30,50,.600,14,46,.304,9,12,.750,111
2019-11-04,POR,GSW,L 118-127,240,47,105,.448,34,65,.523,13,40,.325,11,14,.786,118,42,86,.488,32,60,.533,10,26,.385,33,36,.917,127
2019-11-05,LAL,CHI,W 118-112,240,45,92,.489,34,59,.576,11,33,.333,17,24,.708,118,43,85,.506,29,53,.547,14,32,.438,12,23,.522,112
2019-11-08,ORL,MEM,W 118-86,240,44,93,.473,37,65,.569,7,28,.250,23,27,.852,118,32,86,.372,21,57,.368,11,29,.379,11,13,.846,86
2019-11-22,CHO,WAS,L 118-125,240,48,93,.516,34,59,.576,14,34,.412,8,8,1.000,118,48,91,.527,34,57,.596,14,34,.412,15,20,.750,125
2019-11-25,UTA,MIL,L 118-122,240,43,85,.506,22,40,.550,21,45,.467,11,12,.917,118,43,97,.443,30,56,.536,13,41,.317,23,29,.793,122
2019-12-03,DAL,NOP,W 118-97,240,38,88,.432,19,43,.442,19,45,.422,23,27,.852,118,38,94,.404,27,53,.509,11,41,.268,10,15,.667,97
2019-12-04,ATL,BRK,L 118-130,240,48,90,.533,39,64,.609,9,26,.346,13,21,.619,118,50,101,.495,36,70,.514,14,31,.452,16,18,.889,130
2019-12-09,HOU,SAC,L 118-119,240,41,84,.488,24,34,.706,17,50,.340,19,23,.826,118,40,88,.455,20,43,.465,20,45,.444,19,22,.864,119
2019-12-14,DAL,MIA,L 118-122 (OT),265,45,101,.446,28,57,.491,17,44,.386,11,17,.647,118,39,91,.429,23,51,.451,16,40,.400,28,34,.824,122
2019-12-16,MEM,MIA,W 118-111,240,42,86,.488,29,50,.580,13,36,.361,21,30,.700,118,37,81,.457,26,57,.456,11,24,.458,26,31,.839,111
2019-12-19,SAS,BRK,W 118-105,240,43,96,.448,30,63,.476,13,33,.394,19,23,.826,118,35,83,.422,28,47,.596,7,36,.194,28,30,.933,105
2019-12-20,POR,ORL,W 118-103,240,42,84,.500,25,48,.521,17,36,.472,17,19,.895,118,39,106,.368,32,78,.410,7,28,.250,18,26,.692,103
2019-12-20,WAS,TOR,L 118-122,240,40,87,.460,26,48,.542,14,39,.359,24,32,.750,118,38,78,.487,26,48,.542,12,30,.400,34,44,.773,122
2019-12-22,OKC,LAC,W 118-112,240,46,97,.474,37,70,.529,9,27,.333,17,20,.850,118,40,86,.465,29,59,.492,11,27,.407,21,24,.875,112
2019-12-23,ATL,CLE,L 118-121,240,45,95,.474,30,53,.566,15,42,.357,13,17,.765,118,50,96,.521,39,67,.582,11,29,.379,10,12,.833,121
2019-12-25,BOS,TOR,W 118-102,240,46,92,.500,32,59,.542,14,33,.424,12,14,.857,118,38,80,.475,30,57,.526,8,23,.348,18,22,.818,102
2020-01-03,HOU,PHI,W 118-108,240,41,86,.477,29,54,.537,12,32,.375,24,32,.750,118,42,92,.457,36,65,.554,6,27,.222,18,25,.720,108
2020-01-04,SAS,MIL,L 118-127,240,38,92,.413,27,60,.450,11,32,.344,31,34,.912,118,43,87,.494,26,42,.619,17,45,.378,24,33,.727,127
2020-01-05,MIN,CLE,W 118-103,240,47,95,.495,33,57,.579,14,38,.368,10,13,.769,118,40,84,.476,32,59,.542,8,25,.320,15,19,.789,103
2020-01-06,DAL,CHI,W 118-110,240,44,84,.524,28,43,.651,16,41,.390,14,19,.737,118,46,98,.469,37,67,.552,9,31,.290,9,11,.818,110
2020-01-14,UTA,BRK,W 118-107,240,46,92,.500,33,56,.589,13,36,.361,13,15,.867,118,45,90,.500,37,64,.578,8,26,.308,9,15,.600,107
2020-01-15,LAL,ORL,L 118-119,240,48,97,.495,33,59,.559,15,38,.395,7,11,.636,118,43,94,.457,33,68,.485,10,26,.385,23,29,.793,119
2019-10-24,ATL,DET,W 117-100,240,44,86,.512,33,55,.600,11,31,.355,18,21,.857,117,35,85,.412,25,48,.521,10,37,.270,20,22,.909,100
2019-10-24,MIL,HOU,W 117-111,240,46,99,.465,30,53,.566,16,46,.348,9,18,.500,117,33,90,.367,17,42,.405,16,48,.333,29,39,.744,111
2019-10-26,PHI,DET,W 117-111,240,42,87,.483,29,53,.547,13,34,.382,20,30,.667,117,41,76,.539,33,57,.579,8,19,.421,21,36,.583,111
2019-10-30,CLE,CHI,W 117-111,240,41,78,.526,31,54,.574,10,24,.417,25,31,.806,117,39,90,.433,25,51,.490,14,39,.359,19,23,.826,111
2019-10-30,PHI,MIN,W 117-95,240,43,92,.467,34,67,.507,9,25,.360,22,28,.786,117,32,81,.395,22,46,.478,10,35,.286,21,28,.750,95
2019-11-09,HOU,CHI,W 117-94,240,39,83,.470,20,39,.513,19,44,.432,20,28,.714,117,37,98,.378,33,66,.500,4,32,.125,16,18,.889,94
2019-11-12,MIA,DET,W 117-108,240,41,77,.532,27,45,.600,14,32,.438,21,27,.778,117,34,78,.436,19,37,.514,15,41,.366,25,37,.676,108
2019-11-13,CHO,MEM,L 117-119,240,43,87,.494,27,51,.529,16,36,.444,15,19,.789,117,48,89,.539,31,54,.574,17,35,.486,6,9,.667,119
2019-11-16,BRK,CHI,W 117-111,240,40,88,.455,30,45,.667,10,43,.233,27,31,.871,117,32,91,.352,23,52,.442,9,39,.231,38,41,.927,111
2019-11-18,DAL,SAS,W 117-110,240,42,84,.500,25,43,.581,17,41,.415,16,23,.696,117,44,96,.458,36,72,.500,8,24,.333,14,16,.875,110
2019-11-25,POR,CHI,W 117-94,240,46,89,.517,38,62,.613,8,27,.296,17,22,.773,117,36,86,.419,27,47,.574,9,39,.231,13,20,.650,94
2019-11-25,MIA,CHO,W 117-100,240,40,77,.519,27,46,.587,13,31,.419,24,28,.857,117,36,87,.414,27,54,.500,9,33,.273,19,25,.760,100
2019-11-26,DEN,WAS,W 117-104,240,47,90,.522,41,66,.621,6,24,.250,17,23,.739,117,40,95,.421,30,55,.545,10,40,.250,14,21,.667,104
2019-11-27,HOU,MIA,W 117-108,240,38,83,.458,23,39,.590,15,44,.341,26,33,.788,117,37,80,.463,23,43,.535,14,37,.378,20,27,.741,108
2019-12-02,IND,MEM,W 117-104,240,44,88,.500,28,50,.560,16,38,.421,13,15,.867,117,38,89,.427,28,51,.549,10,38,.263,18,19,.947,104
2019-12-03,LAC,POR,W 117-97,240,43,94,.457,26,60,.433,17,34,.500,14,25,.560,117,39,91,.429,32,64,.500,7,27,.259,12,15,.800,97
2019-12-11,BOS,IND,L 117-122,240,43,87,.494,29,51,.569,14,36,.389,17,22,.773,117,41,85,.482,31,60,.517,10,25,.400,30,36,.833,122
2019-12-12,CLE,SAS,W 117-109 (OT),265,44,96,.458,29,51,.569,15,45,.333,14,20,.700,117,42,86,.488,37,70,.529,5,16,.313,20,25,.800,109
2019-12-13,MIN,LAC,L 117-124,240,38,85,.447,28,44,.636,10,41,.244,31,37,.838,117,39,79,.494,28,54,.519,11,25,.440,35,39,.897,124
2019-12-19,LAC,HOU,L 117-122,240,43,86,.500,27,49,.551,16,37,.432,15,19,.789,117,43,86,.500,29,49,.592,14,37,.378,22,29,.759,122
2019-12-20,DAL,PHI,W 117-98,240,43,83,.518,29,50,.580,14,33,.424,17,22,.773,117,38,90,.422,28,56,.500,10,34,.294,12,18,.667,98
2019-12-22,MIL,IND,W 117-89,240,44,104,.423,29,60,.483,15,44,.341,14,17,.824,117,37,100,.370,25,60,.417,12,40,.300,3,5,.600,89
2019-12-27,CLE,BOS,L 117-129,240,44,85,.518,35,62,.565,9,23,.391,20,29,.690,117,49,95,.516,35,55,.636,14,40,.350,17,19,.895,129
2019-12-28,MIA,PHI,W 117-116 (OT),265,42,94,.447,32,66,.485,10,28,.357,23,29,.793,117,42,89,.472,32,59,.542,10,30,.333,22,29,.759,116
2019-12-29,MEM,CHO,W 117-104,240,45,93,.484,35,58,.603,10,35,.286,17,17,1.000,117,37,86,.430,28,55,.509,9,31,.290,21,32,.656,104
2019-12-31,SAS,GSW,W 117-113 (OT),265,45,96,.469,31,65,.477,14,31,.452,13,17,.765,117,44,96,.458,32,69,.464,12,27,.444,13,18,.722,113
2019-12-31,TOR,CLE,W 117-97,240,40,84,.476,23,45,.511,17,39,.436,20,25,.800,117,37,87,.425,27,49,.551,10,38,.263,13,16,.813,97
2020-01-01,LAL,PHO,W 117-107,240,43,90,.478,36,62,.581,7,28,.250,24,34,.706,117,42,86,.488,36,63,.571,6,23,.261,17,23,.739,107
2020-01-01,NYK,POR,W 117-93,240,47,98,.480,33,62,.532,14,36,.389,9,14,.643,117,37,94,.394,27,62,.435,10,32,.313,9,15,.600,93
2020-01-04,NOP,SAC,W 117-115,240,38,87,.437,22,42,.524,16,45,.356,25,33,.758,117,38,85,.447,26,64,.406,12,21,.571,27,36,.750,115
2020-01-07,LAL,NYK,W 117-87,240,41,82,.500,24,46,.522,17,36,.472,18,21,.857,117,37,95,.389,33,75,.440,4,20,.200,9,16,.563,87
2020-01-10,BRK,MIA,W 117-113,240,45,93,.484,30,49,.612,15,44,.341,12,19,.632,117,44,85,.518,37,56,.661,7,29,.241,18,21,.857,113
2020-01-13,NOP,DET,W 117-110 (OT),265,43,103,.417,34,77,.442,9,26,.346,22,27,.815,117,40,99,.404,29,67,.433,11,32,.344,19,24,.792,110
2020-01-13,OKC,MIN,W 117-104,240,41,82,.500,29,52,.558,12,30,.400,23,26,.885,117,38,91,.418,26,56,.464,12,35,.343,16,21,.762,104
2020-01-15,POR,HOU,W 117-107,240,41,95,.432,30,59,.508,11,36,.306,24,29,.828,117,38,96,.396,22,47,.468,16,49,.327,15,23,.652,107
2020-01-15,PHI,BRK,W 117-106,240,45,88,.511,34,58,.586,11,30,.367,16,25,.640,117,38,87,.437,26,62,.419,12,25,.480,18,30,.600,106
2019-10-25,NOP,DAL,L 116-123,240,45,98,.459,30,57,.526,15,41,.366,11,15,.733,116,45,93,.484,31,53,.585,14,40,.350,19,26,.731,123
2019-10-27,MIN,MIA,W 116-109,240,39,91,.429,26,46,.565,13,45,.289,25,33,.758,116,42,85,.494,27,49,.551,15,36,.417,10,15,.667,109
2019-10-28,HOU,OKC,W 116-112,240,39,90,.433,29,46,.630,10,44,.227,28,33,.848,116,41,94,.436,28,59,.475,13,35,.371,17,24,.708,112
2019-10-30,BOS,MIL,W 116-105,240,41,92,.446,24,51,.471,17,41,.415,17,21,.810,116,38,82,.463,24,37,.649,14,45,.311,15,24,.625,105
2019-11-01,HOU,BRK,L 116-123,240,41,99,.414,29,51,.569,12,48,.250,22,27,.815,116,42,85,.494,23,53,.434,19,32,.594,20,28,.714,123
2019-11-11,BOS,DAL,W 116-106,240,41,86,.477,26,51,.510,15,35,.429,19,25,.760,116,37,89,.416,26,47,.553,11,42,.262,21,28,.750,106
2019-11-11,NOP,HOU,L 116-122,240,41,95,.432,27,50,.540,14,45,.311,20,27,.741,116,44,85,.518,32,44,.727,12,41,.293,22,32,.688,122
2019-11-15,MIN,WAS,L 116-137,240,42,89,.472,31,52,.596,11,37,.297,21,29,.724,116,54,100,.540,44,72,.611,10,28,.357,19,25,.760,137
2019-11-16,SAS,POR,L 116-121,240,41,88,.466,36,70,.514,5,18,.278,29,34,.853,116,42,93,.452,29,54,.537,13,39,.333,24,26,.923,121
2019-11-19,PHO,SAC,L 116-120,240,38,89,.427,26,53,.491,12,36,.333,28,34,.824,116,42,79,.532,29,48,.604,13,31,.419,23,25,.920,120
2019-11-22,BRK,SAC,W 116-97,240,41,81,.506,29,47,.617,12,34,.353,22,31,.710,116,39,86,.453,35,60,.583,4,26,.154,15,19,.789,97
2019-11-22,MIA,CHI,W 116-108,240,39,79,.494,25,41,.610,14,38,.368,24,28,.857,116,41,90,.456,31,60,.517,10,30,.333,16,20,.800,108
2019-11-23,ATL,TOR,L 116-119,240,47,90,.522,33,56,.589,14,34,.412,8,11,.727,116,40,88,.455,27,51,.529,13,37,.351,26,30,.867,119
2019-11-23,CHI,CHO,W 116-115,240,43,95,.453,21,48,.438,22,47,.468,8,12,.667,116,44,80,.550,32,52,.615,12,28,.429,15,22,.682,115
2019-11-24,DEN,PHO,W 116-104,240,43,91,.473,29,60,.483,14,31,.452,16,23,.696,116,41,82,.500,29,47,.617,12,35,.343,10,12,.833,104
2019-11-27,ORL,CLE,W 116-104,240,45,93,.484,33,60,.550,12,33,.364,14,17,.824,116,37,81,.457,26,47,.553,11,34,.324,19,22,.864,104
2019-11-30,IND,PHI,L 116-119,240,42,76,.553,31,54,.574,11,22,.500,21,25,.840,116,38,77,.494,27,54,.500,11,23,.478,32,36,.889,119
Date,Tm,Opp,Result,MP,FG_T,FGA_T,FG%_T,2P_T,2PA_T,2P%_T,3P_T,3PA_T,3P%_T,FT_T,FTA_T,FT%_T,PTS_T,FG_O,FGA_O,FG%_O,2P_O,2PA_O,2P%_O,3P_O,3PA_O,3P%_O,FT_O,FTA_O,FT%_O,PTS_O
2019-12-04,SAC,POR,L 116-127,240,44,95,.463,33,61,.541,11,34,.324,17,23,.739,116,47,84,.560,31,52,.596,16,32,.500,17,21,.810,127
2019-12-11,HOU,CLE,W 116-110,240,43,87,.494,26,45,.578,17,42,.405,13,13,1.000,116,46,89,.517,33,57,.579,13,32,.406,5,8,.625,110
2019-12-11,MIN,UTA,L 116-127,240,40,91,.440,25,50,.500,15,41,.366,21,26,.808,116,47,83,.566,31,48,.646,16,35,.457,17,22,.773,127
2019-12-13,PHI,NOP,W 116-109,240,43,87,.494,36,67,.537,7,20,.350,23,34,.676,116,38,88,.432,29,64,.453,9,24,.375,24,35,.686,109
2019-12-16,MIL,DAL,L 116-120,240,44,105,.419,33,64,.516,11,41,.268,17,24,.708,116,41,88,.466,25,47,.532,16,41,.390,22,27,.815,120
2019-12-25,GSW,HOU,W 116-104,240,41,87,.471,32,59,.542,9,28,.321,25,28,.893,116,37,100,.370,21,49,.429,16,51,.314,14,16,.875,104
2019-12-28,CHI,ATL,W 116-81,240,43,87,.494,28,56,.500,15,31,.484,15,19,.789,116,32,86,.372,23,52,.442,9,34,.265,8,11,.727,81
2019-12-28,PHI,MIA,L 116-117 (OT),265,42,89,.472,32,59,.542,10,30,.333,22,29,.759,116,42,94,.447,32,66,.485,10,28,.357,23,29,.793,117
2019-12-30,POR,PHO,L 116-122,240,44,96,.458,30,62,.484,14,34,.412,14,18,.778,116,44,92,.478,31,69,.449,13,23,.565,21,22,.955,122
2020-01-02,IND,DEN,L 116-124,240,43,82,.524,31,56,.554,12,26,.462,18,25,.720,116,46,87,.529,38,60,.633,8,27,.296,24,27,.889,124
2020-01-04,ATL,IND,W 116-111,240,42,82,.512,32,50,.640,10,32,.313,22,24,.917,116,36,87,.414,26,60,.433,10,27,.370,29,35,.829,111
2020-01-09,MIN,POR,W 116-102,240,44,89,.494,31,57,.544,13,32,.406,15,21,.714,116,35,96,.365,24,59,.407,11,37,.297,21,31,.677,102
2020-01-10,IND,CHI,W 116-105,240,48,84,.571,37,54,.685,11,30,.367,9,14,.643,116,37,80,.463,19,39,.487,18,41,.439,13,16,.813,105
2020-01-12,WAS,UTA,L 116-127,240,47,93,.505,40,71,.563,7,22,.318,15,17,.882,116,48,90,.533,38,60,.633,10,30,.333,21,25,.840,127
2020-01-15,DET,BOS,W 116-103,240,47,78,.603,35,46,.761,12,32,.375,10,19,.526,116,41,83,.494,32,55,.582,9,28,.321,12,20,.600,103
2020-01-17,IND,MIN,W 116-114,240,46,82,.561,38,58,.655,8,24,.333,16,20,.800,116,40,88,.455,23,49,.469,17,39,.436,17,21,.810,114
2019-11-02,MIL,TOR,W 115-105,240,41,89,.461,28,51,.549,13,38,.342,20,25,.800,115,34,84,.405,19,48,.396,15,36,.417,22,25,.880,105
2019-11-02,OKC,NOP,W 115-104,240,41,90,.456,26,53,.491,15,37,.405,18,23,.783,115,40,94,.426,29,62,.468,11,32,.344,13,22,.591,104
2019-11-04,WAS,DET,W 115-99,240,43,93,.462,35,64,.547,8,29,.276,21,25,.840,115,34,82,.415,21,55,.382,13,27,.481,18,23,.783,99
2019-11-08,POR,BRK,L 115-119,240,40,97,.412,29,67,.433,11,30,.367,24,25,.960,115,41,99,.414,25,62,.403,16,37,.432,21,30,.700,119
2019-11-09,NOP,CHO,W 115-110,240,40,75,.533,26,42,.619,14,33,.424,21,30,.700,115,36,88,.409,24,53,.453,12,35,.343,26,34,.765,110
2019-11-09,SAS,BOS,L 115-135,240,39,99,.394,25,69,.362,14,30,.467,23,30,.767,115,48,94,.511,34,57,.596,14,37,.378,25,28,.893,135
2019-11-12,PHO,LAL,L 115-123,240,43,91,.473,27,53,.509,16,38,.421,13,17,.765,115,51,95,.537,41,70,.586,10,25,.400,11,21,.524,123
2019-11-14,CHI,MIL,L 115-124,240,38,93,.409,20,50,.400,18,43,.419,21,25,.840,115,42,88,.477,36,55,.655,6,33,.182,34,47,.723,124
2019-11-18,IND,BRK,W 115-86,240,44,101,.436,30,68,.441,14,33,.424,13,17,.765,115,30,84,.357,19,50,.380,11,34,.324,15,24,.625,86
2019-11-18,MIL,CHI,W 115-101,240,38,82,.463,23,41,.561,15,41,.366,24,35,.686,115,39,97,.402,27,63,.429,12,34,.353,11,14,.786,101
2019-11-19,NOP,POR,W 115-104,240,41,93,.441,28,57,.491,13,36,.361,20,24,.833,115,40,92,.435,24,63,.381,16,29,.552,8,13,.615,104
2019-11-22,PHI,SAS,W 115-104,240,46,89,.517,36,63,.571,10,26,.385,13,19,.684,115,43,85,.506,37,67,.552,6,18,.333,12,16,.750,104
2019-11-23,CHO,CHI,L 115-116,240,44,80,.550,32,52,.615,12,28,.429,15,22,.682,115,43,95,.453,21,48,.438,22,47,.468,8,12,.667,116
2019-12-01,MEM,MIN,W 115-107,240,41,100,.410,25,60,.417,16,40,.400,17,21,.810,115,33,85,.388,22,49,.449,11,36,.306,30,35,.857,107
2019-12-07,HOU,PHO,W 115-109,240,41,91,.451,30,51,.588,11,40,.275,22,30,.733,115,40,96,.417,29,61,.475,11,35,.314,18,28,.643,109
2019-12-10,POR,NYK,W 115-87,240,39,90,.433,22,49,.449,17,41,.415,20,24,.833,115,32,91,.352,25,53,.472,7,38,.184,16,26,.615,87
2019-12-11,MEM,PHO,W 115-108,240,42,87,.483,32,63,.508,10,24,.417,21,26,.808,115,37,93,.398,28,59,.475,9,34,.265,25,30,.833,108
2019-12-12,PHI,BOS,W 115-109,240,41,82,.500,27,54,.500,14,28,.500,19,23,.826,115,42,91,.462,31,60,.517,11,31,.355,14,17,.824,109
2019-12-14,DET,HOU,W 115-107,240,41,92,.446,29,55,.527,12,37,.324,21,25,.840,115,41,102,.402,28,57,.491,13,45,.289,12,18,.667,107
2019-12-21,SAC,MEM,L 115-119,240,43,100,.430,32,64,.500,11,36,.306,18,24,.750,115,40,83,.482,25,48,.521,15,35,.429,24,29,.828,119
2019-12-23,TOR,IND,L 115-120 (OT),265,43,94,.457,32,54,.593,11,40,.275,18,24,.750,115,45,95,.474,27,53,.509,18,42,.429,12,20,.600,120
2019-12-23,MEM,SAS,L 115-145,240,45,96,.469,30,59,.508,15,37,.405,10,16,.625,115,60,89,.674,45,65,.692,15,24,.625,10,14,.714,145
2019-12-23,NYK,WAS,L 115-121,240,44,93,.473,29,57,.509,15,36,.417,12,15,.800,115,47,100,.470,37,70,.529,10,30,.333,17,30,.567,121
2019-12-26,POR,UTA,L 115-121,240,43,89,.483,28,55,.509,15,34,.441,14,19,.737,115,46,81,.568,32,45,.711,14,36,.389,15,22,.682,121
2019-12-29,SAC,DEN,L 115-120,240,45,85,.529,32,51,.627,13,34,.382,12,17,.706,115,42,81,.519,34,52,.654,8,29,.276,28,31,.903,120
2019-12-30,BRK,MIN,L 115-122 (OT),265,40,99,.404,25,58,.431,15,41,.366,20,27,.741,115,42,104,.404,25,60,.417,17,44,.386,21,29,.724,122
2019-12-31,IND,PHI,W 115-97,240,42,86,.488,31,61,.508,11,25,.440,20,26,.769,115,37,91,.407,31,62,.500,6,29,.207,17,20,.850,97
2020-01-04,SAC,NOP,L 115-117,240,38,85,.447,26,64,.406,12,21,.571,27,36,.750,115,38,87,.437,22,42,.524,16,45,.356,25,33,.758,117
2020-01-06,ATL,DEN,L 115-123,240,35,77,.455,17,38,.447,18,39,.462,27,32,.844,115,47,92,.511,38,65,.585,9,27,.333,20,27,.741,123
2020-01-06,IND,CHO,W 115-104,240,47,89,.528,37,63,.587,10,26,.385,11,14,.786,115,37,81,.457,27,51,.529,10,30,.333,20,22,.909,104
2020-01-07,DET,CLE,W 115-113,240,42,91,.462,29,58,.500,13,33,.394,18,21,.857,115,42,85,.494,28,54,.519,14,31,.452,15,16,.938,113
2020-01-08,ATL,HOU,L 115-122,240,39,106,.368,26,62,.419,13,44,.295,24,27,.889,115,39,92,.424,26,47,.553,13,45,.289,31,41,.756,122
2020-01-09,CLE,DET,W 115-112 (OT),265,48,91,.527,43,71,.606,5,20,.250,14,20,.700,115,48,98,.490,42,78,.538,6,20,.300,10,16,.625,112
2020-01-13,POR,CHO,W 115-112,240,42,83,.506,26,46,.565,16,37,.432,15,19,.789,115,40,90,.444,22,52,.423,18,38,.474,14,18,.778,112
2020-01-15,CHI,WAS,W 115-106,240,43,85,.506,29,47,.617,14,38,.368,15,22,.682,115,37,79,.468,26,52,.500,11,27,.407,21,26,.808,106
2020-01-17,MIA,OKC,W 115-108,240,41,84,.488,27,48,.563,14,36,.389,19,24,.792,115,37,84,.440,19,38,.500,18,46,.391,16,18,.889,108
2019-11-02,PHO,MEM,W 114-105,240,44,88,.500,30,54,.556,14,34,.412,12,16,.750,114,42,86,.488,33,58,.569,9,28,.321,12,19,.632,105
2019-11-04,PHO,PHI,W 114-109,240,41,77,.532,30,49,.612,11,28,.393,21,27,.778,114,42,89,.472,29,60,.483,13,29,.448,12,20,.600,109
2019-11-09,OKC,GSW,W 114-108,240,43,79,.544,29,49,.592,14,30,.467,14,17,.824,114,42,85,.494,35,63,.556,7,22,.318,17,17,1.000,108
2019-11-10,PHI,CHO,W 114-106,240,46,84,.548,36,56,.643,10,28,.357,12,16,.750,114,38,84,.452,24,51,.471,14,33,.424,16,22,.727,106
2019-11-11,DET,MIN,L 114-120,240,39,87,.448,23,55,.418,16,32,.500,20,25,.800,114,45,89,.506,30,55,.545,15,34,.441,15,19,.789,120
2019-11-12,BRK,UTA,L 114-119,240,41,90,.456,30,53,.566,11,37,.297,21,25,.840,114,43,92,.467,37,66,.561,6,26,.231,27,35,.771,119
2019-11-13,SAS,MIN,L 114-129,240,44,90,.489,41,73,.562,3,17,.176,23,29,.793,114,45,91,.495,34,57,.596,11,34,.324,28,34,.824,129
2019-11-13,TOR,POR,W 114-106,240,42,92,.457,28,60,.467,14,32,.438,16,17,.941,114,38,96,.396,21,48,.438,17,48,.354,13,16,.813,106
2019-11-17,PHI,CLE,W 114-95,240,46,84,.548,37,61,.607,9,23,.391,13,17,.765,114,34,90,.378,28,65,.431,6,25,.240,21,24,.875,95
2019-11-17,MEM,DEN,L 114-131,240,39,84,.464,23,48,.479,16,36,.444,20,24,.833,114,49,89,.551,31,57,.544,18,32,.563,15,23,.652,131
2019-11-19,GSW,MEM,W 114-95,240,43,90,.478,34,61,.557,9,29,.310,19,22,.864,114,36,88,.409,27,63,.429,9,25,.360,14,19,.737,95
2019-11-25,MEM,IND,L 114-126,240,46,96,.479,33,67,.493,13,29,.448,9,13,.692,114,51,94,.543,33,61,.541,18,33,.545,6,10,.600,126
2019-11-25,LAL,SAS,W 114-104,240,44,89,.494,30,56,.536,14,33,.424,12,18,.667,114,41,88,.466,31,63,.492,10,25,.400,12,15,.800,104
2019-11-26,LAC,DAL,W 114-99,240,41,97,.423,30,64,.469,11,33,.333,21,30,.700,114,30,79,.380,19,41,.463,11,38,.289,28,35,.800,99
2019-11-27,LAL,NOP,W 114-110,240,44,85,.518,36,61,.590,8,24,.333,18,25,.720,114,34,84,.405,17,44,.386,17,40,.425,25,30,.833,110
2019-12-01,DAL,LAL,W 114-100,240,42,97,.433,25,48,.521,17,49,.347,13,18,.722,114,40,87,.460,33,60,.550,7,27,.259,13,16,.813,100
2019-12-04,MIN,DAL,L 114-121,240,37,89,.416,20,51,.392,17,38,.447,23,26,.885,114,46,92,.500,35,55,.636,11,37,.297,18,23,.783,121
2019-12-04,PHO,ORL,L 114-128,240,43,88,.489,28,55,.509,15,33,.455,13,20,.650,114,49,85,.576,35,60,.583,14,25,.560,16,20,.800,128
2019-12-10,CHO,WAS,W 114-107,240,38,85,.447,22,44,.500,16,41,.390,22,28,.786,114,38,90,.422,27,55,.491,11,35,.314,20,25,.800,107
2019-12-12,DEN,POR,W 114-99,240,42,88,.477,24,52,.462,18,36,.500,12,19,.632,114,41,86,.477,32,56,.571,9,30,.300,8,11,.727,99
2019-12-13,MEM,MIL,L 114-127,240,38,98,.388,18,49,.367,20,49,.408,18,23,.783,114,44,87,.506,33,57,.579,11,30,.367,28,33,.848,127
2019-12-13,UTA,GSW,W 114-106,240,37,79,.468,21,41,.512,16,38,.421,24,31,.774,114,41,91,.451,32,62,.516,9,29,.310,15,22,.682,106
2019-12-20,BOS,DET,W 114-93,240,45,86,.523,36,59,.610,9,27,.333,15,21,.714,114,34,85,.400,23,54,.426,11,31,.355,14,19,.737,93
2019-12-20,CLE,MEM,W 114-107,240,40,92,.435,23,55,.418,17,37,.459,17,23,.739,114,44,102,.431,30,61,.492,14,41,.341,5,7,.714,107
2019-12-20,NYK,MIA,L 114-129,240,41,94,.436,31,60,.517,10,34,.294,22,33,.667,114,43,77,.558,25,39,.641,18,38,.474,25,34,.735,129
2019-12-21,UTA,CHO,W 114-107,240,39,75,.520,22,41,.537,17,34,.500,19,20,.950,114,39,85,.459,27,56,.482,12,29,.414,17,22,.773,107
2020-01-04,LAC,MEM,L 114-140,240,45,101,.446,38,71,.535,7,30,.233,17,22,.773,114,49,96,.510,31,57,.544,18,39,.462,24,28,.857,140
2020-01-04,DEN,WAS,L 114-128,240,40,87,.460,34,58,.586,6,29,.207,28,34,.824,114,50,91,.549,44,75,.587,6,16,.375,22,27,.815,128
2020-01-05,PHO,MEM,L 114-121,240,43,95,.453,37,69,.536,6,26,.231,22,26,.846,114,45,83,.542,27,41,.659,18,42,.429,13,17,.765,121
2020-01-07,SAC,PHO,W 114-103,240,37,84,.440,22,48,.458,15,36,.417,25,28,.893,114,37,77,.481,26,42,.619,11,35,.314,18,22,.818,103
2020-01-08,BOS,SAS,L 114-129,240,37,89,.416,24,51,.471,13,38,.342,27,30,.900,114,48,87,.552,39,58,.672,9,29,.310,24,26,.923,129
2020-01-10,DAL,LAL,L 114-129,240,39,96,.406,28,58,.483,11,38,.289,25,37,.676,114,47,89,.528,37,65,.569,10,24,.417,25,32,.781,129
2020-01-12,DEN,LAC,W 114-104,240,37,77,.481,26,52,.500,11,25,.440,29,37,.784,114,38,84,.452,30,51,.588,8,33,.242,20,26,.769,104
2020-01-13,ORL,SAC,W 114-112,240,40,92,.435,31,63,.492,9,29,.310,25,30,.833,114,45,87,.517,33,56,.589,12,31,.387,10,11,.909,112
2020-01-17,MIN,IND,L 114-116,240,40,88,.455,23,49,.469,17,39,.436,17,21,.810,114,46,82,.561,38,58,.655,8,24,.333,16,20,.800,116
2019-10-25,BRK,NYK,W 113-109,240,37,78,.474,21,41,.512,16,37,.432,23,34,.676,113,38,81,.469,21,56,.375,17,25,.680,16,28,.571,109
2019-10-26,UTA,SAC,W 113-81,240,44,78,.564,26,41,.634,18,37,.486,7,12,.583,113,30,81,.370,23,55,.418,7,26,.269,14,17,.824,81
2019-10-28,SAS,POR,W 113-110,240,41,85,.482,34,63,.540,7,22,.318,24,32,.750,113,39,100,.390,29,67,.433,10,33,.303,22,27,.815,110
2019-10-30,DET,TOR,L 113-125,240,41,88,.466,27,58,.466,14,30,.467,17,23,.739,113,51,86,.593,38,59,.644,13,27,.481,10,12,.833,125
2019-11-02,DET,BRK,W 113-109,240,41,91,.451,33,64,.516,8,27,.296,23,29,.793,113,43,93,.462,33,61,.541,10,32,.313,13,17,.765,109
2019-11-03,SAC,NYK,W 113-92,240,41,85,.482,26,46,.565,15,39,.385,16,25,.640,113,32,80,.400,24,49,.490,8,31,.258,20,31,.645,92
2019-11-05,CLE,BOS,L 113-119,240,40,95,.421,27,62,.435,13,33,.394,20,22,.909,113,48,85,.565,36,55,.655,12,30,.400,11,15,.733,119
2019-11-06,CHI,ATL,W 113-93,240,41,82,.500,28,49,.571,13,33,.394,18,27,.667,113,30,74,.405,24,44,.545,6,30,.200,27,35,.771,93
2019-11-08,CLE,WAS,W 113-100,240,41,90,.456,35,63,.556,6,27,.222,25,29,.862,113,45,96,.469,38,65,.585,7,31,.226,3,6,.500,100
2019-11-10,TOR,LAL,W 113-104,240,43,89,.483,31,53,.585,12,36,.333,15,22,.682,113,41,94,.436,31,64,.484,10,30,.333,12,19,.632,104
2019-11-10,ATL,POR,L 113-124 (OT),265,42,104,.404,31,63,.492,11,41,.268,18,25,.720,113,45,104,.433,33,68,.485,12,36,.333,22,28,.786,124
2019-11-11,MEM,SAS,W 113-109,240,44,87,.506,33,59,.559,11,28,.393,14,20,.700,113,42,90,.467,30,60,.500,12,30,.400,13,17,.765,109
2019-11-20,TOR,ORL,W 113-97,240,45,87,.517,36,60,.600,9,27,.333,14,19,.737,113,35,91,.385,26,59,.441,9,32,.281,18,28,.643,97
Date,Tm,Opp,Result,MP,FG_T,FGA_T,FG%_T,2P_T,2PA_T,2P%_T,3P_T,3PA_T,3P%_T,FT_T,FTA_T,FT%_T,PTS_T,FG_O,FGA_O,FG%_O,2P_O,2PA_O,2P%_O,3P_O,3PA_O,3P%_O,FT_O,FTA_O,FT%_O,PTS_O
2019-11-22,UTA,GSW,W 113-109,240,43,85,.506,29,53,.547,14,32,.438,13,16,.813,113,43,94,.457,31,66,.470,12,28,.429,11,12,.917,109
2019-11-23,PHI,MIA,W 113-86,240,42,83,.506,28,54,.519,14,29,.483,15,17,.882,113,30,75,.400,24,51,.471,6,24,.250,20,27,.741,86
2019-11-24,SAC,WAS,W 113-106,240,39,81,.481,28,50,.560,11,31,.355,24,28,.857,113,42,92,.457,29,58,.500,13,34,.382,9,12,.750,106
2019-11-25,ATL,MIN,L 113-125,240,41,94,.436,31,62,.500,10,32,.313,21,26,.808,113,41,90,.456,26,55,.473,15,35,.429,28,36,.778,125
2019-11-27,MIN,SAS,W 113-101,240,37,85,.435,19,45,.422,18,40,.450,21,27,.778,113,41,97,.423,36,68,.529,5,29,.172,14,17,.824,101
2019-11-29,PHO,DAL,L 113-120,240,41,93,.441,28,55,.509,13,38,.342,18,25,.720,113,35,85,.412,18,38,.474,17,47,.362,33,38,.868,120
2019-12-01,BOS,NYK,W 113-104,240,41,93,.441,26,52,.500,15,41,.366,16,22,.727,113,35,76,.461,27,50,.540,8,26,.308,26,37,.703,104
2019-12-02,CHI,SAC,W 113-106,240,36,75,.480,20,38,.526,16,37,.432,25,29,.862,113,40,83,.482,31,50,.620,9,33,.273,17,20,.850,106
2019-12-05,PHI,WAS,L 113-119,240,41,77,.532,28,49,.571,13,28,.464,18,24,.750,113,41,90,.456,30,63,.476,11,27,.407,26,32,.813,119
2019-12-06,POR,LAL,L 113-136,240,39,86,.453,29,52,.558,10,34,.294,25,29,.862,113,46,85,.541,29,49,.592,17,36,.472,27,33,.818,136
2019-12-11,CHO,BRK,W 113-108,240,36,88,.409,21,53,.396,15,35,.429,26,32,.813,113,38,88,.432,28,50,.560,10,38,.263,22,33,.667,108
2019-12-13,LAL,MIA,W 113-110,240,43,87,.494,31,50,.620,12,37,.324,15,23,.652,113,39,85,.459,29,52,.558,10,33,.303,22,28,.786,110
2019-12-16,CLE,TOR,L 113-133,240,44,90,.489,32,55,.582,12,35,.343,13,17,.765,113,52,89,.584,36,57,.632,16,32,.500,13,17,.765,133
2019-12-18,DEN,ORL,W 113-104,240,40,84,.476,29,57,.509,11,27,.407,22,25,.880,113,37,87,.425,26,58,.448,11,29,.379,19,21,.905,104
2019-12-21,POR,MIN,W 113-106,240,40,94,.426,27,59,.458,13,35,.371,20,25,.800,113,38,87,.437,23,50,.460,15,37,.405,15,16,.938,106
2019-12-23,GSW,MIN,W 113-104,240,38,87,.437,26,57,.456,12,30,.400,25,30,.833,113,35,87,.402,24,53,.453,11,34,.324,23,29,.793,104
2019-12-23,DEN,PHO,W 113-111,240,43,78,.551,28,50,.560,15,28,.536,12,15,.800,113,42,87,.483,29,50,.580,13,37,.351,14,18,.778,111
2019-12-23,HOU,SAC,W 113-104,240,39,87,.448,24,48,.500,15,39,.385,20,23,.870,113,41,87,.471,34,57,.596,7,30,.233,15,23,.652,104
2019-12-27,MIA,IND,W 113-112,240,40,89,.449,24,51,.471,16,38,.421,17,19,.895,113,44,90,.489,30,59,.508,14,31,.452,10,12,.833,112
2019-12-28,TOR,BOS,W 113-97,240,44,84,.524,30,50,.600,14,34,.412,11,17,.647,113,31,78,.397,24,46,.522,7,32,.219,28,36,.778,97
2019-12-31,GSW,SAS,L 113-117 (OT),265,44,96,.458,32,69,.464,12,27,.444,13,18,.722,113,45,96,.469,31,65,.477,14,31,.452,13,17,.765,117
2020-01-03,NOP,LAL,L 113-123,240,48,102,.471,37,65,.569,11,37,.297,6,7,.857,113,43,86,.500,29,57,.509,14,29,.483,23,28,.821,123
2020-01-06,OKC,PHI,L 113-120,240,40,89,.449,28,60,.467,12,29,.414,21,31,.677,113,46,90,.511,33,64,.516,13,26,.500,15,18,.833,120
2020-01-07,CLE,DET,L 113-115,240,42,85,.494,28,54,.519,14,31,.452,15,16,.938,113,42,91,.462,29,58,.500,13,33,.394,18,21,.857,115
2020-01-09,OKC,HOU,W 113-92,240,43,87,.494,32,55,.582,11,32,.344,16,20,.800,113,34,89,.382,23,49,.469,11,40,.275,13,14,.929,92
2020-01-10,MIA,BRK,L 113-117,240,44,85,.518,37,56,.661,7,29,.241,18,21,.857,113,45,93,.484,30,49,.612,15,44,.341,12,19,.632,117
2020-01-13,BOS,CHI,W 113-101,240,39,83,.470,30,60,.500,9,23,.391,26,29,.897,113,37,81,.457,31,56,.554,6,25,.240,21,26,.808,101
2020-01-17,MEM,CLE,W 113-109,240,45,89,.506,36,61,.590,9,28,.321,14,20,.700,113,41,92,.446,32,56,.571,9,36,.250,18,26,.692,109
2019-10-22,LAC,LAL,W 112-102,240,42,81,.519,31,50,.620,11,31,.355,17,24,.708,112,37,85,.435,24,52,.462,13,33,.394,15,21,.714,102
2019-10-25,BOS,TOR,W 112-106,240,42,109,.385,29,71,.408,13,38,.342,15,16,.938,112,37,78,.474,19,42,.452,18,36,.500,14,17,.824,106
2019-10-25,SAC,POR,L 112-122,240,37,87,.425,22,50,.440,15,37,.405,23,27,.852,112,46,85,.541,35,55,.636,11,30,.367,19,22,.864,122
2019-10-28,OKC,HOU,L 112-116,240,41,94,.436,28,59,.475,13,35,.371,17,24,.708,112,39,90,.433,29,46,.630,10,44,.227,28,33,.848,116
2019-10-28,CLE,MIL,L 112-129,240,45,100,.450,33,61,.541,12,39,.308,10,12,.833,112,48,92,.522,31,54,.574,17,38,.447,16,24,.667,129
2019-10-29,MIA,ATL,W 112-97,240,33,73,.452,20,42,.476,13,31,.419,33,45,.733,112,35,83,.422,24,44,.545,11,39,.282,16,24,.667,97
2019-11-01,CHI,DET,W 112-106,240,39,89,.438,23,49,.469,16,40,.400,18,23,.783,112,41,85,.482,35,56,.625,6,29,.207,18,24,.750,106
2019-11-05,CHI,LAL,L 112-118,240,43,85,.506,29,53,.547,14,32,.438,12,23,.522,112,45,92,.489,34,59,.576,11,33,.333,17,24,.708,118
2019-11-06,GSW,HOU,L 112-129,240,38,96,.396,25,63,.397,13,33,.394,23,28,.821,112,48,97,.495,27,52,.519,21,45,.467,12,19,.632,129
2019-11-07,OKC,SAS,L 112-121,240,42,80,.525,32,59,.542,10,21,.476,18,24,.750,112,51,94,.543,42,74,.568,9,20,.450,10,11,.909,121
2019-11-08,IND,DET,W 112-106,240,43,83,.518,39,68,.574,4,15,.267,22,25,.880,112,39,86,.453,26,53,.491,13,33,.394,15,18,.833,106
2019-11-10,BRK,PHO,L 112-138,240,44,91,.484,36,57,.632,8,34,.235,16,17,.941,112,52,99,.525,33,57,.579,19,42,.452,15,19,.789,138
2019-11-13,ORL,PHI,W 112-97,240,38,86,.442,28,54,.519,10,32,.313,26,34,.765,112,40,91,.440,32,61,.525,8,30,.267,9,13,.692,97
2019-11-14,ATL,PHO,L 112-128,240,40,91,.440,32,60,.533,8,31,.258,24,30,.800,112,41,85,.482,26,46,.565,15,39,.385,31,38,.816,128
2019-11-18,MIN,UTA,W 112-102,240,41,89,.461,27,51,.529,14,38,.368,16,19,.842,112,35,96,.365,23,65,.354,12,31,.387,20,26,.769,102
2019-11-19,LAL,OKC,W 112-107,240,43,89,.483,29,58,.500,14,31,.452,12,19,.632,112,38,80,.475,29,52,.558,9,28,.321,22,25,.880,107
2019-11-29,BRK,BOS,W 112-107,240,43,93,.462,26,52,.500,17,41,.415,9,13,.692,112,41,93,.441,32,65,.492,9,28,.321,16,21,.762,107
2019-12-04,BOS,MIA,W 112-93,240,35,79,.443,19,38,.500,16,41,.390,26,32,.813,112,34,77,.442,20,39,.513,14,38,.368,11,17,.647,93
2019-12-06,MIA,WAS,W 112-103,240,42,86,.488,32,58,.552,10,28,.357,18,24,.750,112,39,91,.429,27,52,.519,12,39,.308,13,14,.929,103
2019-12-07,MEM,UTA,L 112-126,240,43,81,.531,33,46,.717,10,35,.286,16,25,.640,112,45,80,.563,26,46,.565,19,34,.559,17,18,.944,126
2019-12-11,NOP,MIL,L 112-127,240,39,88,.443,23,43,.535,16,45,.356,18,22,.818,112,50,93,.538,31,54,.574,19,39,.487,8,9,.889,127
2019-12-11,LAC,TOR,W 112-92,240,38,86,.442,26,46,.565,12,40,.300,24,27,.889,112,31,88,.352,23,52,.442,8,36,.222,22,25,.880,92
2019-12-18,TOR,DET,W 112-99,240,39,91,.429,26,56,.464,13,35,.371,21,24,.875,112,39,87,.448,33,52,.635,6,35,.171,15,22,.682,99
2019-12-18,GSW,POR,L 112-122,240,41,103,.398,25,65,.385,16,38,.421,14,23,.609,112,44,97,.454,35,66,.530,9,31,.290,25,28,.893,122
2019-12-21,ATL,BRK,L 112-122,240,39,105,.371,28,57,.491,11,48,.229,23,27,.852,112,46,100,.460,35,70,.500,11,30,.367,19,28,.679,122
2019-12-22,LAC,OKC,L 112-118,240,40,86,.465,29,59,.492,11,27,.407,21,24,.875,112,46,97,.474,37,70,.529,9,27,.333,17,20,.850,118
2019-12-25,NOP,DEN,W 112-100,240,41,90,.456,23,47,.489,18,43,.419,12,12,1.000,112,37,92,.402,25,55,.455,12,37,.324,14,18,.778,100
2019-12-27,MIL,ATL,W 112-86,240,46,91,.505,35,63,.556,11,28,.393,9,13,.692,112,33,91,.363,21,50,.420,12,41,.293,8,14,.571,86
2019-12-27,IND,MIA,L 112-113,240,44,90,.489,30,59,.508,14,31,.452,10,12,.833,112,40,89,.449,24,51,.471,16,38,.421,17,19,.895,113
2019-12-28,PHO,SAC,W 112-110,240,45,86,.523,36,60,.600,9,26,.346,13,15,.867,112,41,84,.488,29,53,.547,12,31,.387,16,24,.667,110
2019-12-29,HOU,NOP,L 112-127,240,42,81,.519,27,42,.643,15,39,.385,13,20,.650,112,50,102,.490,32,58,.552,18,44,.409,9,13,.692,127
2020-01-02,DET,LAC,L 112-126,240,40,94,.426,33,61,.541,7,33,.212,25,35,.714,112,50,92,.543,39,64,.609,11,28,.393,15,21,.714,126
2020-01-03,NYK,PHO,L 112-120,240,41,92,.446,31,55,.564,10,37,.270,20,30,.667,112,42,90,.467,32,62,.516,10,28,.357,26,33,.788,120
2020-01-07,MIN,MEM,L 112-119,240,40,90,.444,25,43,.581,15,47,.319,17,21,.810,112,46,89,.517,38,61,.623,8,28,.286,19,21,.905,119
2020-01-08,TOR,CHO,W 112-110 (OT),265,42,94,.447,28,58,.483,14,36,.389,14,20,.700,112,38,86,.442,23,49,.469,15,37,.405,19,26,.731,110
2020-01-09,DET,CLE,L 112-115 (OT),265,48,98,.490,42,78,.538,6,20,.300,10,16,.625,112,48,91,.527,43,71,.606,5,20,.250,14,20,.700,115
2020-01-13,CHO,POR,L 112-115,240,40,90,.444,22,52,.423,18,38,.474,14,18,.778,112,42,83,.506,26,46,.565,16,37,.432,15,19,.789,115
2020-01-13,SAC,ORL,L 112-114,240,45,87,.517,33,56,.589,12,31,.387,10,11,.909,112,40,92,.435,31,63,.492,9,29,.310,25,30,.833,114
2020-01-17,POR,DAL,L 112-120,240,44,85,.518,35,55,.636,9,30,.300,15,22,.682,112,39,89,.438,19,42,.452,20,47,.426,22,28,.786,120
2019-10-23,NYK,SAS,L 111-120,240,44,94,.468,34,64,.531,10,30,.333,13,18,.722,111,42,83,.506,35,62,.565,7,21,.333,29,36,.806,120
2019-10-24,HOU,MIL,L 111-117,240,33,90,.367,17,42,.405,16,48,.333,29,39,.744,111,46,99,.465,30,53,.566,16,46,.348,9,18,.500,117
2019-10-26,DET,PHI,L 111-117,240,41,76,.539,33,57,.579,8,19,.421,21,36,.583,111,42,87,.483,29,53,.547,13,34,.382,20,30,.667,117
2019-10-28,LAC,CHO,W 111-96,240,40,83,.482,28,50,.560,12,33,.364,19,21,.905,111,36,83,.434,22,44,.500,14,39,.359,10,14,.714,96
2019-10-30,CHI,CLE,L 111-117,240,39,90,.433,25,51,.490,14,39,.359,19,23,.826,111,41,78,.526,31,54,.574,10,24,.417,25,31,.806,117
2019-10-30,SAC,CHO,L 111-118,240,44,96,.458,30,50,.600,14,46,.304,9,12,.750,111,46,84,.548,30,52,.577,16,32,.500,10,14,.714,118
2019-11-03,CLE,DAL,L 111-131,240,39,96,.406,21,48,.438,18,48,.375,15,22,.682,111,50,94,.532,30,53,.566,20,41,.488,11,13,.846,131
2019-11-12,IND,OKC,W 111-85,240,46,94,.489,39,71,.549,7,23,.304,12,13,.923,111,29,82,.354,23,57,.404,6,25,.240,21,24,.875,85
2019-11-15,HOU,IND,W 111-102,240,36,89,.404,22,43,.512,14,46,.304,25,29,.862,111,37,82,.451,29,49,.592,8,33,.242,20,26,.769,102
2019-11-15,ORL,SAS,W 111-109,240,36,87,.414,24,58,.414,12,29,.414,27,34,.794,111,45,89,.506,32,63,.508,13,26,.500,6,10,.600,109
2019-11-16,CHI,BRK,L 111-117,240,32,91,.352,23,52,.442,9,39,.231,38,41,.927,111,40,88,.455,30,45,.667,10,43,.233,27,31,.871,117
2019-11-23,IND,ORL,W 111-106,240,43,79,.544,33,55,.600,10,24,.417,15,16,.938,111,43,92,.467,30,61,.492,13,31,.419,7,9,.778,106
2019-11-23,SAS,NYK,W 111-104,240,40,75,.533,28,52,.538,12,23,.522,19,28,.679,111,40,93,.430,25,53,.472,15,40,.375,9,15,.600,104
2019-11-27,MIL,ATL,W 111-102,240,42,88,.477,32,54,.593,10,34,.294,17,27,.630,111,38,94,.404,27,60,.450,11,34,.324,15,22,.682,102
2019-11-30,ATL,HOU,L 111-158,240,38,89,.427,23,43,.535,15,46,.326,20,25,.800,111,52,89,.584,27,38,.711,25,51,.490,29,34,.853,158
2019-12-06,BRK,CHO,W 111-104,240,42,88,.477,27,50,.540,15,38,.395,12,15,.800,111,36,83,.434,19,43,.442,17,40,.425,15,17,.882,104
2019-12-12,DET,DAL,L 111-122,240,40,89,.449,25,47,.532,15,42,.357,16,23,.696,111,45,88,.511,29,44,.659,16,44,.364,16,23,.696,122
2019-12-14,WAS,MEM,L 111-128,240,36,85,.424,22,47,.468,14,38,.368,25,32,.781,111,48,84,.571,37,57,.649,11,27,.407,21,24,.875,128
2019-12-15,DEN,NYK,W 111-105,240,44,94,.468,34,66,.515,10,28,.357,13,19,.684,111,44,94,.468,36,62,.581,8,32,.250,9,10,.900,105
2019-12-16,MIA,MEM,L 111-118,240,37,81,.457,26,57,.456,11,24,.458,26,31,.839,111,42,86,.488,29,50,.580,13,36,.361,21,30,.700,118
2019-12-16,POR,PHO,W 111-110,240,40,84,.476,26,50,.520,14,34,.412,17,20,.850,111,41,90,.456,29,56,.518,12,34,.353,16,19,.842,110
2019-12-19,UTA,ATL,W 111-106,240,39,83,.470,33,59,.559,6,24,.250,27,38,.711,111,39,90,.433,28,61,.459,11,29,.379,17,19,.895,106
2019-12-19,MIL,LAL,W 111-104,240,36,77,.468,20,38,.526,16,39,.410,23,32,.719,111,37,80,.463,25,45,.556,12,35,.343,18,23,.783,104
2019-12-23,PHO,DEN,L 111-113,240,42,87,.483,29,50,.580,13,37,.351,14,18,.778,111,43,78,.551,28,50,.560,15,28,.536,12,15,.800,113
2019-12-25,LAC,LAL,W 111-106,240,39,85,.459,30,60,.500,9,25,.360,24,32,.750,111,39,96,.406,27,51,.529,12,45,.267,16,21,.762,106
2019-12-28,MIL,ORL,W 111-100,240,43,84,.512,30,47,.638,13,37,.351,12,18,.667,111,35,87,.402,21,52,.404,14,35,.400,16,19,.842,100
2020-01-02,BRK,DAL,L 111-123,240,42,91,.462,30,54,.556,12,37,.324,15,17,.882,111,45,89,.506,27,51,.529,18,38,.474,15,17,.882,123
2020-01-04,IND,ATL,L 111-116,240,36,87,.414,26,60,.433,10,27,.370,29,35,.829,111,42,82,.512,32,50,.640,10,32,.313,22,24,.917,116
2020-01-04,BOS,CHI,W 111-104,240,43,82,.524,35,63,.556,8,19,.421,17,21,.810,111,34,80,.425,21,46,.457,13,34,.382,23,31,.742,104
2020-01-04,DET,GSW,W 111-104,240,43,83,.518,32,56,.571,11,27,.407,14,16,.875,111,33,82,.402,22,61,.361,11,21,.524,27,32,.844,104
2020-01-05,POR,MIA,L 111-122,240,40,87,.460,27,50,.540,13,37,.351,18,20,.900,111,47,90,.522,29,46,.630,18,44,.409,10,16,.625,122
2020-01-06,SAC,GSW,W 111-98,240,39,81,.481,24,51,.471,15,30,.500,18,23,.783,111,34,86,.395,29,60,.483,5,26,.192,25,32,.781,98
2020-01-07,OKC,BRK,W 111-103 (OT),265,38,92,.413,27,55,.491,11,37,.297,24,29,.828,111,40,98,.408,29,61,.475,11,37,.297,12,16,.750,103
Date,Tm,Opp,Result,MP,FG_T,FGA_T,FG%_T,2P_T,2PA_T,2P%_T,3P_T,3PA_T,3P%_T,FT_T,FTA_T,FT%_T,PTS_T,FG_O,FGA_O,FG%_O,2P_O,2PA_O,2P%_O,3P_O,3PA_O,3P%_O,FT_O,FTA_O,FT%_O,PTS_O
2020-01-10,NYK,NOP,L 111-123,240,46,100,.460,41,73,.562,5,27,.185,14,20,.700,111,48,86,.558,30,48,.625,18,38,.474,9,17,.529,123
2020-01-10,WAS,ATL,W 111-101,240,42,112,.375,32,83,.386,10,29,.345,17,28,.607,111,41,89,.461,34,60,.567,7,29,.241,12,24,.500,101
2020-01-11,CLE,DEN,W 111-103,240,44,89,.494,32,52,.615,12,37,.324,11,13,.846,111,41,95,.432,33,56,.589,8,39,.205,13,18,.722,103
2020-01-17,WAS,TOR,L 111-140,240,40,89,.449,25,54,.463,15,35,.429,16,23,.696,111,52,91,.571,30,48,.625,22,43,.512,14,16,.875,140
2019-10-23,IND,DET,L 110-119,240,41,89,.461,33,68,.485,8,21,.381,20,24,.833,110,41,78,.526,30,54,.556,11,24,.458,26,33,.788,119
2019-10-25,CHI,MEM,W 110-102,240,40,93,.430,28,51,.549,12,42,.286,18,24,.750,110,39,94,.415,29,65,.446,10,29,.345,14,20,.700,102
2019-10-26,CLE,IND,W 110-99,240,40,80,.500,29,49,.592,11,31,.355,19,29,.655,110,39,87,.448,29,59,.492,10,28,.357,11,13,.846,99
2019-10-28,POR,SAS,L 110-113,240,39,100,.390,29,67,.433,10,33,.303,22,27,.815,110,41,85,.482,34,63,.540,7,22,.318,24,32,.750,113
2019-10-30,GSW,PHO,L 110-121,240,36,82,.439,28,54,.519,8,28,.286,30,36,.833,110,44,96,.458,29,60,.483,15,36,.417,18,21,.857,121
2019-10-30,UTA,LAC,W 110-96,240,44,80,.550,33,56,.589,11,24,.458,11,16,.688,110,39,82,.476,31,59,.525,8,23,.348,10,12,.833,96
2019-11-01,DAL,LAL,L 110-119 (OT),265,40,102,.392,26,66,.394,14,36,.389,16,23,.696,110,47,96,.490,38,64,.594,9,32,.281,16,21,.762,119
2019-11-01,GSW,SAS,L 110-127,240,39,84,.464,26,56,.464,13,28,.464,19,21,.905,110,44,93,.473,31,58,.534,13,35,.371,26,30,.867,127
2019-11-09,CHO,NOP,L 110-115,240,36,88,.409,24,53,.453,12,35,.343,26,34,.765,110,40,75,.533,26,42,.619,14,33,.424,21,30,.700,115
2019-11-16,DAL,TOR,W 110-102,240,37,88,.420,28,49,.571,9,39,.231,27,33,.818,110,37,89,.416,20,48,.417,17,41,.415,11,15,.733,102
2019-11-18,SAS,DAL,L 110-117,240,44,96,.458,36,72,.500,8,24,.333,14,16,.875,110,42,84,.500,25,43,.581,17,41,.415,16,23,.696,117
2019-11-23,CLE,POR,W 110-104,240,37,87,.425,27,56,.482,10,31,.323,26,32,.813,110,39,87,.448,25,47,.532,14,40,.350,12,16,.750,104
2019-11-27,BRK,BOS,L 110-121,240,40,90,.444,19,34,.559,21,56,.375,9,19,.474,110,43,97,.443,30,63,.476,13,34,.382,22,24,.917,121
2019-11-27,NOP,LAL,L 110-114,240,34,84,.405,17,44,.386,17,40,.425,25,30,.833,110,44,85,.518,36,61,.590,8,24,.333,18,25,.720,114
2019-11-29,CLE,MIL,L 110-119,240,44,88,.500,27,54,.500,17,34,.500,5,10,.500,110,45,88,.511,33,54,.611,12,34,.353,17,23,.739,119
2019-11-29,CHO,DET,W 110-107,240,40,83,.482,21,45,.467,19,38,.500,11,15,.733,110,41,83,.494,26,48,.542,15,35,.429,10,20,.500,107
2019-12-01,UTA,TOR,L 110-130,240,38,90,.422,25,55,.455,13,35,.371,21,29,.724,110,47,90,.522,28,54,.519,19,36,.528,17,21,.810,130
2019-12-03,TOR,MIA,L 110-121 (OT),265,35,91,.385,24,48,.500,11,43,.256,29,36,.806,110,45,99,.455,30,61,.492,15,38,.395,16,21,.762,121
2019-12-08,SAC,DAL,W 110-106,240,44,85,.518,31,51,.608,13,34,.382,9,11,.818,110,41,86,.477,24,42,.571,17,44,.386,7,8,.875,106
2019-12-08,MIA,CHI,W 110-105 (OT),265,32,77,.416,21,42,.500,11,35,.314,35,44,.795,110,35,80,.438,22,44,.500,13,36,.361,22,27,.815,105
2019-12-08,PHI,TOR,W 110-104,240,40,79,.506,26,47,.553,14,32,.438,16,21,.762,110,38,88,.432,27,55,.491,11,33,.333,17,20,.850,104
2019-12-09,BOS,CLE,W 110-88,240,45,78,.577,30,51,.588,15,27,.556,5,8,.625,110,36,91,.396,29,60,.483,7,31,.226,9,19,.474,88
2019-12-09,MEM,GSW,W 110-102,240,41,82,.500,26,42,.619,15,40,.375,13,17,.765,110,35,93,.376,24,66,.364,11,27,.407,21,25,.840,102
2019-12-09,LAC,IND,W 110-99,240,40,97,.412,30,65,.462,10,32,.313,20,27,.741,110,34,97,.351,24,62,.387,10,35,.286,21,28,.750,99
2019-12-09,MIL,ORL,W 110-101,240,43,92,.467,27,51,.529,16,41,.390,8,15,.533,110,35,92,.380,25,61,.410,10,31,.323,21,26,.808,101
2019-12-11,CLE,HOU,L 110-116,240,46,89,.517,33,57,.579,13,32,.406,5,8,.625,110,43,87,.494,26,45,.578,17,42,.405,13,13,1.000,116
2019-12-13,IND,ATL,W 110-100,240,46,92,.500,39,70,.557,7,22,.318,11,15,.733,110,39,94,.415,33,66,.500,6,28,.214,16,23,.696,100
2019-12-13,MIA,LAL,L 110-113,240,39,85,.459,29,52,.558,10,33,.303,22,28,.786,110,43,87,.494,31,50,.620,12,37,.324,15,23,.652,113
2019-12-14,DEN,OKC,W 110-102,240,43,85,.506,36,58,.621,7,27,.259,17,23,.739,110,38,81,.469,32,58,.552,6,23,.261,20,23,.870,102
2019-12-14,TOR,BRK,W 110-102,240,38,98,.388,24,58,.414,14,40,.350,20,25,.800,110,39,101,.386,27,55,.491,12,46,.261,12,17,.706,102
2019-12-16,PHO,POR,L 110-111,240,41,90,.456,29,56,.518,12,34,.353,16,19,.842,110,40,84,.476,26,50,.520,14,34,.412,17,20,.850,111
2019-12-17,CHO,SAC,W 110-102,240,39,81,.481,26,51,.510,13,30,.433,19,27,.704,110,38,91,.418,24,52,.462,14,39,.359,12,13,.923,102
2019-12-18,CHI,WAS,W 110-109 (OT),265,39,97,.402,28,60,.467,11,37,.297,21,24,.875,110,34,95,.358,20,50,.400,14,45,.311,27,32,.844,109
2019-12-22,TOR,DAL,W 110-107,240,37,94,.394,27,60,.450,10,34,.294,26,31,.839,110,35,90,.389,20,44,.455,15,46,.326,22,27,.815,107
2019-12-26,MEM,OKC,W 110-97,240,46,84,.548,36,59,.610,10,25,.400,8,11,.727,110,38,92,.413,28,57,.491,10,35,.286,11,13,.846,97
2019-12-28,MEM,DEN,L 110-119,240,41,84,.488,32,54,.593,9,30,.300,19,25,.760,110,45,93,.484,36,64,.563,9,29,.310,20,27,.741,119
2019-12-28,SAC,PHO,L 110-112,240,41,84,.488,29,53,.547,12,31,.387,16,24,.667,110,45,86,.523,36,60,.600,9,26,.346,13,15,.867,112
2020-01-06,CHI,DAL,L 110-118,240,46,98,.469,37,67,.552,9,31,.290,9,11,.818,110,44,84,.524,28,43,.651,16,41,.390,14,19,.737,118
2020-01-08,CHO,TOR,L 110-112 (OT),265,38,86,.442,23,49,.469,15,37,.405,19,26,.731,110,42,94,.447,28,58,.483,14,36,.389,14,20,.700,112
2020-01-11,OKC,LAL,L 110-125,240,43,92,.467,34,61,.557,9,31,.290,15,17,.882,110,51,99,.515,36,67,.537,15,32,.469,8,10,.800,125
2020-01-13,DET,NOP,L 110-117 (OT),265,40,99,.404,29,67,.433,11,32,.344,19,24,.792,110,43,103,.417,34,77,.442,9,26,.346,22,27,.815,117
2020-01-14,PHO,ATL,L 110-123,240,40,87,.460,36,67,.537,4,20,.200,26,32,.813,110,46,93,.495,32,62,.516,14,31,.452,17,20,.850,123
2020-01-14,HOU,MEM,L 110-121,240,37,86,.430,23,41,.561,14,45,.311,22,24,.917,110,46,91,.505,33,54,.611,13,37,.351,16,19,.842,121
2019-10-25,NYK,BRK,L 109-113,240,38,81,.469,21,56,.375,17,25,.680,16,28,.571,109,37,78,.474,21,41,.512,16,37,.432,23,34,.676,113
2019-10-27,MIA,MIN,L 109-116,240,42,85,.494,27,49,.551,15,36,.417,10,15,.667,109,39,91,.429,26,46,.565,13,45,.289,25,33,.758,116
2019-10-29,DAL,DEN,W 109-106,240,41,84,.488,28,47,.596,13,37,.351,14,24,.583,109,43,91,.473,32,59,.542,11,32,.344,9,13,.692,106
2019-11-02,BRK,DET,L 109-113,240,43,93,.462,33,61,.541,10,32,.313,13,17,.765,109,41,91,.451,33,64,.516,8,27,.296,23,29,.793,113
2019-11-02,WAS,MIN,L 109-131,240,37,95,.389,25,60,.417,12,35,.343,23,27,.852,109,51,94,.543,34,55,.618,17,39,.436,12,17,.706,131
2019-11-04,PHI,PHO,L 109-114,240,42,89,.472,29,60,.483,13,29,.448,12,20,.600,109,41,77,.532,30,49,.612,11,28,.393,21,27,.778,114
2019-11-05,DEN,MIA,W 109-89,240,45,86,.523,36,63,.571,9,23,.391,10,16,.625,109,32,88,.364,23,59,.390,9,29,.310,16,25,.640,89
2019-11-08,ATL,SAC,L 109-121,240,46,87,.529,37,59,.627,9,28,.321,8,14,.571,109,42,76,.553,24,45,.533,18,31,.581,19,22,.864,121
2019-11-10,IND,ORL,W 109-102,240,48,91,.527,39,71,.549,9,20,.450,4,5,.800,109,41,89,.461,26,53,.491,15,36,.417,5,6,.833,102
2019-11-11,SAS,MEM,L 109-113,240,42,90,.467,30,60,.500,12,30,.400,13,17,.765,109,44,87,.506,33,59,.559,11,28,.393,14,20,.700,113
2019-11-15,CHO,DET,W 109-106,240,43,96,.448,30,61,.492,13,35,.371,10,16,.625,109,40,81,.494,25,46,.543,15,35,.429,11,11,1.000,106
2019-11-15,SAS,ORL,L 109-111,240,45,89,.506,32,63,.508,13,26,.500,6,10,.600,109,36,87,.414,24,58,.414,12,29,.414,27,34,.794,111
2019-11-16,MIA,NOP,W 109-94,240,44,81,.543,35,57,.614,9,24,.375,12,13,.923,109,37,82,.451,21,47,.447,16,35,.457,4,6,.667,94
2019-11-20,CHI,DET,W 109-89,240,39,91,.429,25,64,.391,14,27,.519,17,26,.654,109,28,83,.337,20,50,.400,8,33,.242,25,32,.781,89
2019-11-20,PHI,NYK,W 109-104,240,39,89,.438,26,57,.456,13,32,.406,18,26,.692,109,40,84,.476,27,59,.458,13,25,.520,11,15,.733,104
2019-11-22,GSW,UTA,L 109-113,240,43,94,.457,31,66,.470,12,28,.429,11,12,.917,109,43,85,.506,29,53,.547,14,32,.438,13,16,.813,113
2019-11-23,LAL,MEM,W 109-108,240,38,84,.452,25,45,.556,13,39,.333,20,29,.690,109,43,89,.483,29,59,.492,14,30,.467,8,13,.615,108
2019-11-24,NOP,LAC,L 109-134,240,43,98,.439,30,57,.526,13,41,.317,10,18,.556,109,46,98,.469,30,55,.545,16,43,.372,26,33,.788,134
2019-11-29,OKC,NOP,W 109-104,240,43,90,.478,30,56,.536,13,34,.382,10,16,.625,109,39,87,.448,28,49,.571,11,38,.289,15,21,.714,104
2019-12-01,MIA,BRK,W 109-106,240,37,95,.389,25,58,.431,12,37,.324,23,28,.821,109,40,91,.440,26,49,.531,14,42,.333,12,16,.750,106
2019-12-02,PHO,CHO,W 109-104,240,39,88,.443,30,46,.652,9,42,.214,22,30,.733,109,38,84,.452,31,59,.525,7,25,.280,21,26,.808,104
2019-12-05,TOR,HOU,L 109-119,240,38,88,.432,26,49,.531,12,39,.308,21,24,.875,109,40,98,.408,18,43,.419,22,55,.400,17,19,.895,119
2019-12-07,PHO,HOU,L 109-115,240,40,96,.417,29,61,.475,11,35,.314,18,28,.643,109,41,91,.451,30,51,.588,11,40,.275,22,30,.733,115
2019-12-09,MIN,PHO,L 109-125,240,40,85,.471,34,63,.540,6,22,.273,23,29,.793,109,47,95,.495,31,55,.564,16,40,.400,15,19,.789,125
2019-12-12,BOS,PHI,L 109-115,240,42,91,.462,31,60,.517,11,31,.355,14,17,.824,109,41,82,.500,27,54,.500,14,28,.500,19,23,.826,115
2019-12-12,SAS,CLE,L 109-117 (OT),265,42,86,.488,37,70,.529,5,16,.313,20,25,.800,109,44,96,.458,29,51,.569,15,45,.333,14,20,.700,117
2019-12-13,NOP,PHI,L 109-116,240,38,88,.432,29,64,.453,9,24,.375,24,35,.686,109,43,87,.494,36,67,.537,7,20,.350,23,34,.676,116
2019-12-14,CHI,LAC,W 109-106,240,40,85,.471,26,54,.481,14,31,.452,15,18,.833,109,35,80,.438,25,58,.431,10,22,.455,26,36,.722,106
2019-12-15,BRK,PHI,W 109-89,240,43,94,.457,34,70,.486,9,24,.375,14,18,.778,109,37,86,.430,32,60,.533,5,26,.192,10,17,.588,89
2019-12-16,HOU,SAS,W 109-107,240,40,98,.408,29,55,.527,11,43,.256,18,27,.667,109,39,91,.429,27,58,.466,12,33,.364,17,20,.850,107
2019-12-16,OKC,CHI,W 109-106,240,35,69,.507,19,35,.543,16,34,.471,23,28,.821,109,43,87,.494,34,56,.607,9,31,.290,11,13,.846,106
2019-12-17,UTA,ORL,W 109-102,240,42,90,.467,27,54,.500,15,36,.417,10,16,.625,109,42,93,.452,35,58,.603,7,35,.200,11,15,.733,102
2019-12-18,BOS,DAL,W 109-103,240,35,86,.407,23,48,.479,12,38,.316,27,30,.900,109,34,87,.391,19,44,.432,15,43,.349,20,25,.800,103
2019-12-18,WAS,CHI,L 109-110 (OT),265,34,95,.358,20,50,.400,14,45,.311,27,32,.844,109,39,97,.402,28,60,.467,11,37,.297,21,24,.875,110
2019-12-20,DEN,MIN,W 109-100,240,44,89,.494,34,61,.557,10,28,.357,11,12,.917,109,36,87,.414,26,45,.578,10,42,.238,18,27,.667,100
2019-12-21,SAS,LAC,L 109-134,240,42,82,.512,32,54,.593,10,28,.357,15,19,.789,109,54,99,.545,42,63,.667,12,36,.333,14,19,.737,134
2019-12-23,DET,PHI,L 109-125,240,43,84,.512,33,54,.611,10,30,.333,13,18,.722,109,52,95,.547,40,65,.615,12,30,.400,9,11,.818,125
2019-12-25,MIL,PHI,L 109-121,240,45,95,.474,32,62,.516,13,33,.394,6,8,.750,109,44,101,.436,23,57,.404,21,44,.477,12,15,.800,121
2019-12-28,DET,SAS,L 109-136,240,40,90,.444,28,54,.519,12,36,.333,17,30,.567,109,53,93,.570,35,58,.603,18,35,.514,12,15,.800,136
2019-12-31,BOS,CHO,W 109-92,240,44,97,.454,30,59,.508,14,38,.368,7,10,.700,109,34,86,.395,22,52,.423,12,34,.353,12,16,.750,92
2020-01-02,CHO,CLE,W 109-106,240,37,83,.446,22,45,.489,15,38,.395,20,24,.833,109,41,81,.506,28,46,.609,13,35,.371,11,14,.786,106
2020-01-02,OKC,SAS,W 109-103,240,43,89,.483,34,64,.531,9,25,.360,14,20,.700,109,40,92,.435,27,61,.443,13,31,.419,10,12,.833,103
2020-01-03,BOS,ATL,W 109-106,240,41,93,.441,35,68,.515,6,25,.240,21,29,.724,109,39,93,.419,23,48,.479,16,45,.356,12,15,.800,106
2020-01-04,UTA,ORL,W 109-96,240,42,93,.452,26,53,.491,16,40,.400,9,14,.643,109,38,85,.447,27,48,.563,11,37,.297,9,12,.750,96
2020-01-09,PHI,BOS,W 109-98,240,43,88,.489,32,61,.525,11,27,.407,12,17,.706,109,38,88,.432,24,52,.462,14,36,.389,8,8,1.000,98
2020-01-10,LAC,GSW,W 109-100,240,41,84,.488,30,45,.667,11,39,.282,16,22,.727,109,37,96,.385,29,57,.509,8,39,.205,18,25,.720,100
2020-01-10,UTA,CHO,W 109-92,240,40,79,.506,22,37,.595,18,42,.429,11,14,.786,109,35,75,.467,27,49,.551,8,26,.308,14,19,.737,92
2020-01-11,DAL,PHI,W 109-91,240,40,79,.506,29,52,.558,11,27,.407,18,27,.667,109,37,98,.378,28,61,.459,9,37,.243,8,12,.667,91
2020-01-11,MIN,HOU,L 109-139,240,36,95,.379,23,47,.489,13,48,.271,24,36,.667,109,49,95,.516,31,50,.620,18,45,.400,23,29,.793,139
2020-01-17,CLE,MEM,L 109-113,240,41,92,.446,32,56,.571,9,36,.250,18,26,.692,109,45,89,.506,36,61,.590,9,28,.321,14,20,.700,113
2019-10-23,DAL,WAS,W 108-100,240,35,76,.461,24,40,.600,11,36,.306,27,33,.818,108,37,93,.398,26,52,.500,11,41,.268,15,18,.833,100
2019-10-23,DEN,POR,W 108-100,240,34,81,.420,16,49,.327,18,32,.563,22,27,.815,108,36,87,.414,29,59,.492,7,28,.250,21,23,.913,100
2019-10-25,DEN,PHO,W 108-107 (OT),265,36,92,.391,29,65,.446,7,27,.259,29,36,.806,108,34,86,.395,26,58,.448,8,28,.286,31,32,.969,107
Date,Tm,Opp,Result,MP,FG_T,FGA_T,FG%_T,2P_T,2PA_T,2P%_T,3P_T,3PA_T,3P%_T,FT_T,FTA_T,FT%_T,PTS_T,FG_O,FGA_O,FG%_O,2P_O,2PA_O,2P%_O,3P_O,3PA_O,3P%_O,FT_O,FTA_O,FT%_O,PTS_O
2019-10-26,TOR,CHI,W 108-84,240,38,82,.463,23,40,.575,15,42,.357,17,18,.944,108,29,97,.299,20,62,.323,9,35,.257,17,25,.680,84
2019-10-30,BRK,IND,L 108-118,240,41,93,.441,31,62,.500,10,31,.323,16,26,.615,108,45,96,.469,34,70,.486,11,26,.423,17,20,.850,118
2019-11-03,IND,CHI,W 108-95,240,40,85,.471,32,59,.542,8,26,.308,20,27,.741,108,36,84,.429,27,55,.491,9,29,.310,14,25,.560,95
2019-11-05,ATL,SAS,W 108-100,240,43,90,.478,32,60,.533,11,30,.367,11,16,.688,108,38,91,.418,30,58,.517,8,33,.242,16,23,.696,100
2019-11-07,BOS,CHO,W 108-87,240,40,93,.430,30,60,.500,10,33,.303,18,23,.783,108,33,86,.384,27,55,.491,6,31,.194,15,21,.714,87
2019-11-07,PHO,MIA,L 108-124,240,37,84,.440,26,52,.500,11,32,.344,23,31,.742,108,45,82,.549,30,54,.556,15,28,.536,19,24,.792,124
2019-11-09,GSW,OKC,L 108-114,240,42,85,.494,35,63,.556,7,22,.318,17,17,1.000,108,43,79,.544,29,49,.592,14,30,.467,14,17,.824,114
2019-11-10,CLE,NYK,W 108-87,240,36,82,.439,28,54,.519,8,28,.286,28,31,.903,108,31,86,.360,22,55,.400,9,31,.290,16,25,.640,87
2019-11-11,GSW,UTA,L 108-122,240,45,94,.479,35,63,.556,10,31,.323,8,14,.571,108,40,81,.494,24,46,.522,16,35,.457,26,32,.813,122
2019-11-12,DET,MIA,L 108-117,240,34,78,.436,19,37,.514,15,41,.366,25,37,.676,108,41,77,.532,27,45,.600,14,32,.438,21,27,.778,117
2019-11-14,MIA,CLE,W 108-97,240,43,79,.544,31,49,.633,12,30,.400,10,11,.909,108,36,85,.424,28,53,.528,8,32,.250,17,21,.810,97
2019-11-17,NOP,GSW,W 108-100,240,37,89,.416,19,43,.442,18,46,.391,16,20,.800,108,37,91,.407,30,66,.455,7,25,.280,19,23,.826,100
2019-11-18,POR,HOU,L 108-132,240,40,96,.417,29,60,.483,11,36,.306,17,23,.739,108,47,100,.470,30,55,.545,17,45,.378,21,26,.808,132
2019-11-22,CHI,MIA,L 108-116,240,41,90,.456,31,60,.517,10,30,.333,16,20,.800,108,39,79,.494,25,41,.610,14,38,.368,24,28,.857,116
2019-11-23,MEM,LAL,L 108-109,240,43,89,.483,29,59,.492,14,30,.467,8,13,.615,108,38,84,.452,25,45,.556,13,39,.333,20,29,.690,109
2019-11-25,BRK,CLE,W 108-106,240,44,94,.468,33,60,.550,11,34,.324,9,11,.818,108,40,94,.426,27,62,.435,13,32,.406,13,20,.650,106
2019-11-27,MIA,HOU,L 108-117,240,37,80,.463,23,43,.535,14,37,.378,20,27,.741,108,38,83,.458,23,39,.590,15,44,.341,26,33,.788,117
2019-12-06,BOS,DEN,W 108-95,240,44,82,.537,31,47,.660,13,35,.371,7,8,.875,108,39,94,.415,34,64,.531,5,30,.167,12,15,.800,95
2019-12-06,DET,IND,W 108-101,240,39,87,.448,28,62,.452,11,25,.440,19,26,.731,108,38,83,.458,29,59,.492,9,24,.375,16,20,.800,101
2019-12-08,OKC,POR,W 108-96,240,35,85,.412,24,53,.453,11,32,.344,27,34,.794,108,36,100,.360,27,67,.403,9,33,.273,15,18,.833,96
2019-12-11,BRK,CHO,L 108-113,240,38,88,.432,28,50,.560,10,38,.263,22,33,.667,108,36,88,.409,21,53,.396,15,35,.429,26,32,.813,113
2019-12-11,PHO,MEM,L 108-115,240,37,93,.398,28,59,.475,9,34,.265,25,30,.833,108,42,87,.483,32,63,.508,10,24,.417,21,26,.808,115
2019-12-14,CLE,MIL,L 108-125,240,41,90,.456,26,55,.473,15,35,.429,11,15,.733,108,46,85,.541,32,48,.667,14,37,.378,19,26,.731,125
2019-12-17,BRK,NOP,W 108-101 (OT),265,40,96,.417,29,57,.509,11,39,.282,17,23,.739,108,37,107,.346,26,67,.388,11,40,.275,16,24,.667,101
2019-12-18,MIA,PHI,W 108-104,240,40,85,.471,28,54,.519,12,31,.387,16,20,.800,108,38,90,.422,26,51,.510,12,39,.308,16,18,.889,104
2019-12-20,PHO,OKC,L 108-126,240,38,87,.437,27,55,.491,11,32,.344,21,23,.913,108,49,87,.563,39,63,.619,10,24,.417,18,21,.857,126
2019-12-21,WAS,PHI,L 108-125,240,36,88,.409,29,57,.509,7,31,.226,29,34,.853,108,49,94,.521,35,61,.574,14,33,.424,13,21,.619,125
2019-12-28,HOU,BRK,W 108-98,240,44,101,.436,31,59,.525,13,42,.310,7,16,.438,108,37,92,.402,26,53,.491,11,39,.282,13,21,.619,98
2019-12-29,LAL,DAL,W 108-95,240,38,78,.487,29,55,.527,9,23,.391,23,28,.821,108,32,89,.360,19,46,.413,13,43,.302,18,20,.900,95
2020-01-03,PHI,HOU,L 108-118,240,42,92,.457,36,65,.554,6,27,.222,18,25,.720,108,41,86,.477,29,54,.537,12,32,.375,24,32,.750,118
2020-01-08,IND,MIA,L 108-122,240,40,84,.476,31,57,.544,9,27,.333,19,25,.760,108,43,81,.531,27,43,.628,16,38,.421,20,25,.800,122
2020-01-08,CHI,NOP,L 108-123,240,41,92,.446,27,57,.474,14,35,.400,12,21,.571,108,41,87,.471,26,43,.605,15,44,.341,26,32,.813,123
2020-01-11,CHI,DET,W 108-99,240,42,83,.506,31,48,.646,11,35,.314,13,14,.929,108,36,78,.462,27,50,.540,9,28,.321,18,27,.667,99
2020-01-12,BRK,ATL,W 108-86,240,41,77,.532,31,51,.608,10,26,.385,16,29,.552,108,32,97,.330,20,49,.408,12,48,.250,10,11,.909,86
2020-01-17,OKC,MIA,L 108-115,240,37,84,.440,19,38,.500,18,46,.391,16,18,.889,108,41,84,.488,27,48,.563,14,36,.389,19,24,.792,115
2019-10-23,PHI,BOS,W 107-93,240,37,85,.435,30,56,.536,7,29,.241,26,36,.722,107,33,90,.367,26,64,.406,7,26,.269,20,34,.588,93
2019-10-25,PHO,DEN,L 107-108 (OT),265,34,86,.395,26,58,.448,8,28,.286,31,32,.969,107,36,92,.391,29,65,.446,7,27,.259,29,36,.806,108
2019-10-31,DEN,NOP,L 107-122,240,43,89,.483,36,63,.571,7,26,.269,14,16,.875,107,41,77,.532,26,44,.591,15,33,.455,25,32,.781,122
2019-11-04,HOU,MEM,W 107-100,240,35,93,.376,18,43,.419,17,50,.340,20,29,.690,107,40,94,.426,37,69,.536,3,25,.120,17,21,.810,100
2019-11-06,DAL,ORL,W 107-106,240,36,84,.429,25,53,.472,11,31,.355,24,30,.800,107,39,80,.488,33,56,.589,6,24,.250,22,28,.786,106
2019-11-07,LAC,POR,W 107-101,240,39,89,.438,35,66,.530,4,23,.174,25,30,.833,107,39,104,.375,28,65,.431,11,39,.282,12,16,.750,101
2019-11-12,SAC,POR,W 107-99,240,38,86,.442,27,54,.500,11,32,.344,20,26,.769,107,34,77,.442,26,47,.553,8,30,.267,23,30,.767,99
2019-11-15,MEM,UTA,W 107-106,240,43,96,.448,33,61,.541,10,35,.286,11,13,.846,107,35,87,.402,26,53,.491,9,34,.265,27,32,.844,106
2019-11-19,OKC,LAL,L 107-112,240,38,80,.475,29,52,.558,9,28,.321,22,25,.880,107,43,89,.483,29,58,.500,14,31,.452,12,19,.632,112
2019-11-20,LAC,BOS,W 107-104 (OT),265,39,93,.419,22,48,.458,17,45,.378,12,16,.750,107,41,104,.394,29,59,.492,12,45,.267,10,14,.714,104
2019-11-29,BOS,BRK,L 107-112,240,41,93,.441,32,65,.492,9,28,.321,16,21,.762,107,43,93,.462,26,52,.500,17,41,.415,9,13,.692,112
2019-11-29,DET,CHO,L 107-110,240,41,83,.494,26,48,.542,15,35,.429,10,20,.500,107,40,83,.482,21,45,.467,19,38,.500,11,15,.733,110
2019-11-29,POR,CHI,W 107-103,240,38,84,.452,28,54,.519,10,30,.333,21,28,.750,107,36,94,.383,22,56,.393,14,38,.368,17,25,.680,103
2019-11-29,SAS,LAC,W 107-97,240,40,93,.430,26,57,.456,14,36,.389,13,14,.929,107,36,92,.391,24,59,.407,12,33,.364,13,13,1.000,97
2019-12-01,MIN,MEM,L 107-115,240,33,85,.388,22,49,.449,11,36,.306,30,35,.857,107,41,100,.410,25,60,.417,16,40,.400,17,21,.810,115
2019-12-01,OKC,NOP,W 107-104,240,38,81,.469,27,48,.563,11,33,.333,20,26,.769,107,39,87,.448,22,49,.449,17,38,.447,9,10,.900,104
2019-12-04,IND,OKC,W 107-100,240,42,87,.483,33,63,.524,9,24,.375,14,17,.824,107,41,84,.488,32,58,.552,9,26,.346,9,10,.900,100
2019-12-08,CHO,ATL,L 107-122,240,36,90,.400,25,59,.424,11,31,.355,24,29,.828,107,44,91,.484,26,46,.565,18,45,.400,16,17,.941,122
2019-12-10,WAS,CHO,L 107-114,240,38,90,.422,27,55,.491,11,35,.314,20,25,.800,107,38,85,.447,22,44,.500,16,41,.390,22,28,.786,114
2019-12-13,ORL,HOU,L 107-130,240,40,91,.440,25,54,.463,15,37,.405,12,16,.750,107,48,86,.558,26,47,.553,22,39,.564,12,13,.923,130
2019-12-14,HOU,DET,L 107-115,240,41,102,.402,28,57,.491,13,45,.289,12,18,.667,107,41,92,.446,29,55,.527,12,37,.324,21,25,.840,115
2019-12-15,IND,CHO,W 107-85,240,40,88,.455,30,53,.566,10,35,.286,17,20,.850,107,28,91,.308,23,59,.390,5,32,.156,24,35,.686,85
2019-12-16,SAS,HOU,L 107-109,240,39,91,.429,27,58,.466,12,33,.364,17,20,.850,107,40,98,.408,29,55,.527,11,43,.256,18,27,.667,109
2019-12-18,NOP,MIN,W 107-99,240,38,86,.442,24,53,.453,14,33,.424,17,21,.810,107,36,95,.379,26,56,.464,10,39,.256,17,27,.630,99
2019-12-20,MEM,CLE,L 107-114,240,44,102,.431,30,61,.492,14,41,.341,5,7,.714,107,40,92,.435,23,55,.418,17,37,.459,17,23,.739,114
2019-12-21,CHO,UTA,L 107-114,240,39,85,.459,27,56,.482,12,29,.414,17,22,.773,107,39,75,.520,22,41,.537,17,34,.500,19,20,.950,114
2019-12-21,DET,CHI,L 107-119,240,40,87,.460,24,52,.462,16,35,.457,11,12,.917,107,40,77,.519,22,42,.524,18,35,.514,21,25,.840,119
2019-12-22,DAL,TOR,L 107-110,240,35,90,.389,20,44,.455,15,46,.326,22,27,.815,107,37,94,.394,27,60,.450,10,34,.294,26,31,.839,110
2019-12-23,MIA,UTA,W 107-104,240,37,90,.411,28,65,.431,9,25,.360,24,27,.889,107,39,90,.433,27,54,.500,12,36,.333,14,18,.778,104
2019-12-28,LAC,UTA,L 107-120,240,35,95,.368,23,55,.418,12,40,.300,25,27,.926,107,45,86,.523,28,51,.549,17,35,.486,13,17,.765,120
2019-12-28,NYK,WAS,W 107-100,240,38,85,.447,27,54,.500,11,31,.355,20,26,.769,107,33,96,.344,23,71,.324,10,25,.400,24,31,.774,100
2020-01-01,PHO,LAL,L 107-117,240,42,86,.488,36,63,.571,6,23,.261,17,23,.739,107,43,90,.478,36,62,.581,7,28,.250,24,34,.706,117
2020-01-08,DEN,DAL,W 107-106,240,41,85,.482,32,61,.525,9,24,.375,16,20,.800,107,39,77,.506,27,42,.643,12,35,.343,16,24,.667,106
2020-01-08,MIL,GSW,W 107-98,240,35,87,.402,26,46,.565,9,41,.220,28,32,.875,107,33,87,.379,18,49,.367,15,38,.395,17,20,.850,98
2020-01-14,BRK,UTA,L 107-118,240,45,90,.500,37,64,.578,8,26,.308,9,15,.600,107,46,92,.500,33,56,.589,13,36,.361,13,15,.867,118
2020-01-15,HOU,POR,L 107-117,240,38,96,.396,22,47,.468,16,49,.327,15,23,.652,107,41,95,.432,30,59,.508,11,36,.306,24,29,.828,117
2019-10-25,TOR,BOS,L 106-112,240,37,78,.474,19,42,.452,18,36,.500,14,17,.824,106,42,109,.385,29,71,.408,13,38,.342,15,16,.938,112
2019-10-29,DEN,DAL,L 106-109,240,43,91,.473,32,59,.542,11,32,.344,9,13,.692,106,41,84,.488,28,47,.596,13,37,.351,14,24,.583,109
2019-10-31,MIA,ATL,W 106-97,240,40,84,.476,26,47,.553,14,37,.378,12,19,.632,106,36,88,.409,29,54,.537,7,34,.206,18,26,.692,97
2019-11-01,DET,CHI,L 106-112,240,41,85,.482,35,56,.625,6,29,.207,18,24,.750,106,39,89,.438,23,49,.469,16,40,.400,18,23,.783,112
2019-11-04,MIN,MIL,L 106-134,240,37,103,.359,24,60,.400,13,43,.302,19,22,.864,106,50,93,.538,36,54,.667,14,39,.359,20,30,.667,134
2019-11-06,ORL,DAL,L 106-107,240,39,80,.488,33,56,.589,6,24,.250,22,28,.786,106,36,84,.429,25,53,.472,11,31,.355,24,30,.800,107
2019-11-06,WAS,IND,L 106-121,240,37,95,.389,24,55,.436,13,40,.325,19,19,1.000,106,44,94,.468,32,64,.500,12,30,.400,21,26,.808,121
2019-11-06,UTA,PHI,W 106-104,240,41,89,.461,33,67,.493,8,22,.364,16,24,.667,106,33,80,.413,25,55,.455,8,25,.320,30,34,.882,104
2019-11-08,NYK,DAL,W 106-102,240,37,89,.416,23,61,.377,14,28,.500,18,31,.581,106,37,90,.411,23,46,.500,14,44,.318,14,17,.824,102
2019-11-08,DET,IND,L 106-112,240,39,86,.453,26,53,.491,13,33,.394,15,18,.833,106,43,83,.518,39,68,.574,4,15,.267,22,25,.880,112
2019-11-10,CHO,PHI,L 106-114,240,38,84,.452,24,51,.471,14,33,.424,16,22,.727,106,46,84,.548,36,56,.643,10,28,.357,12,16,.750,114
2019-11-11,DAL,BOS,L 106-116,240,37,89,.416,26,47,.553,11,42,.262,21,28,.750,106,41,86,.477,26,51,.510,15,35,.429,19,25,.760,116
2019-11-13,POR,TOR,L 106-114,240,38,96,.396,21,48,.438,17,48,.354,13,16,.813,106,42,92,.457,28,60,.467,14,32,.438,16,17,.941,114
2019-11-14,NYK,DAL,W 106-103,240,42,94,.447,29,64,.453,13,30,.433,9,11,.818,106,36,84,.429,28,48,.583,8,36,.222,23,31,.742,103
2019-11-15,DET,CHO,L 106-109,240,40,81,.494,25,46,.543,15,35,.429,11,11,1.000,106,43,96,.448,30,61,.492,13,35,.371,10,16,.625,109
2019-11-15,UTA,MEM,L 106-107,240,35,87,.402,26,53,.491,9,34,.265,27,32,.844,106,43,96,.448,33,61,.541,10,35,.286,11,13,.846,107
2019-11-23,ORL,IND,L 106-111,240,43,92,.467,30,61,.492,13,31,.419,7,9,.778,106,43,79,.544,33,55,.600,10,24,.417,15,16,.938,111
2019-11-24,WAS,SAC,L 106-113,240,42,92,.457,29,58,.500,13,34,.382,9,12,.750,106,39,81,.481,28,50,.560,11,31,.355,24,28,.857,113
2019-11-25,CLE,BRK,L 106-108,240,40,94,.426,27,62,.435,13,32,.406,13,20,.650,106,44,94,.468,33,60,.550,11,34,.324,9,11,.818,108
2019-12-01,BRK,MIA,L 106-109,240,40,91,.440,26,49,.531,14,42,.333,12,16,.750,106,37,95,.389,25,58,.431,12,37,.324,23,28,.821,109
2019-12-02,SAC,CHI,L 106-113,240,40,83,.482,31,50,.620,9,33,.273,17,20,.850,106,36,75,.480,20,38,.526,16,37,.432,25,29,.862,113
2019-12-04,CHI,MEM,W 106-99,240,33,77,.429,20,44,.455,13,33,.394,27,37,.730,106,37,96,.385,30,66,.455,7,30,.233,18,21,.857,99
2019-12-04,CHO,GSW,W 106-91,240,40,87,.460,19,39,.487,21,48,.438,5,8,.625,106,36,78,.462,27,55,.491,9,23,.391,10,15,.667,91
2019-12-08,DAL,SAC,L 106-110,240,41,86,.477,24,42,.571,17,44,.386,7,8,.875,106,44,85,.518,31,51,.608,13,34,.382,9,11,.818,110
2019-12-13,GSW,UTA,L 106-114,240,41,91,.451,32,62,.516,9,29,.310,15,22,.682,106,37,79,.468,21,41,.512,16,38,.421,24,31,.774,114
2019-12-14,LAC,CHI,L 106-109,240,35,80,.438,25,58,.431,10,22,.455,26,36,.722,106,40,85,.471,26,54,.481,14,31,.452,15,18,.833,109
2019-12-16,CHI,OKC,L 106-109,240,43,87,.494,34,56,.607,9,31,.290,11,13,.846,106,35,69,.507,19,35,.543,16,34,.471,23,28,.821,109
2019-12-19,ATL,UTA,L 106-111,240,39,90,.433,28,61,.459,11,29,.379,17,19,.895,106,39,83,.470,33,59,.559,6,24,.250,27,38,.711,111
2019-12-20,GSW,NOP,W 106-102,240,36,83,.434,26,50,.520,10,33,.303,24,25,.960,106,39,93,.419,30,59,.508,9,34,.265,15,23,.652,102
Date,Tm,Opp,Result,MP,FG_T,FGA_T,FG%_T,2P_T,2PA_T,2P%_T,3P_T,3PA_T,3P%_T,FT_T,FTA_T,FT%_T,PTS_T,FG_O,FGA_O,FG%_O,2P_O,2PA_O,2P%_O,3P_O,3PA_O,3P%_O,FT_O,FTA_O,FT%_O,PTS_O
2019-12-21,MIN,POR,L 106-113,240,38,87,.437,23,50,.460,15,37,.405,15,16,.938,106,40,94,.426,27,59,.458,13,35,.371,20,25,.800,113
2019-12-25,LAL,LAC,L 106-111,240,39,96,.406,27,51,.529,12,45,.267,16,21,.762,106,39,85,.459,30,60,.500,9,25,.360,24,32,.750,111
2019-12-31,OKC,DAL,W 106-101,240,39,91,.429,33,64,.516,6,27,.222,22,28,.786,106,33,93,.355,18,42,.429,15,51,.294,20,27,.741,101
2020-01-01,MIL,MIN,W 106-104,240,40,94,.426,31,58,.534,9,36,.250,17,26,.654,106,34,91,.374,19,45,.422,15,46,.326,21,28,.750,104
2020-01-02,CLE,CHO,L 106-109,240,41,81,.506,28,46,.609,13,35,.371,11,14,.786,106,37,83,.446,22,45,.489,15,38,.395,20,24,.833,109
2020-01-03,ATL,BOS,L 106-109,240,39,93,.419,23,48,.479,16,45,.356,12,15,.800,106,41,93,.441,35,68,.515,6,25,.240,21,29,.724,109
2020-01-04,CLE,OKC,L 106-121,240,39,85,.459,25,55,.455,14,30,.467,14,17,.824,106,43,96,.448,29,59,.492,14,37,.378,21,26,.808,121
2020-01-05,LAL,DET,W 106-99,240,42,92,.457,36,72,.500,6,20,.300,16,23,.696,106,29,78,.372,18,52,.346,11,26,.423,30,35,.857,99
2020-01-08,DAL,DEN,L 106-107,240,39,77,.506,27,42,.643,12,35,.343,16,24,.667,106,41,85,.482,32,61,.525,9,24,.375,16,20,.800,107
2020-01-10,SAC,MIL,L 106-127,240,44,96,.458,34,61,.557,10,35,.286,8,10,.800,106,47,95,.495,37,56,.661,10,39,.256,23,30,.767,127
2020-01-15,WAS,CHI,L 106-115,240,37,79,.468,26,52,.500,11,27,.407,21,26,.808,106,43,85,.506,29,47,.617,14,38,.368,15,22,.682,115
2020-01-15,MIA,SAS,W 106-100,240,41,88,.466,24,48,.500,17,40,.425,7,13,.538,106,39,89,.438,29,56,.518,10,33,.303,12,15,.800,100
2020-01-15,BRK,PHI,L 106-117,240,38,87,.437,26,62,.419,12,25,.480,18,30,.600,106,45,88,.511,34,58,.586,11,30,.367,16,25,.640,117
2019-10-28,PHI,ATL,W 105-103,240,37,88,.420,26,47,.553,11,41,.268,20,25,.800,105,36,84,.429,27,57,.474,9,27,.333,22,32,.688,103
2019-10-28,NYK,CHI,W 105-98,240,38,91,.418,29,62,.468,9,29,.310,20,32,.625,105,36,85,.424,27,50,.540,9,35,.257,17,21,.810,98
2019-10-30,MIL,BOS,L 105-116,240,38,82,.463,24,37,.649,14,45,.311,15,24,.625,105,41,92,.446,24,51,.471,17,41,.415,17,21,.810,116
2019-11-02,MEM,PHO,L 105-114,240,42,86,.488,33,58,.569,9,28,.321,12,19,.632,105,44,88,.500,30,54,.556,14,34,.412,12,16,.750,114
2019-11-02,TOR,MIL,L 105-115,240,34,84,.405,19,48,.396,15,36,.417,22,25,.880,105,41,89,.461,28,51,.549,13,38,.342,20,25,.800,115
2019-11-03,LAC,UTA,W 105-94,240,36,92,.391,29,60,.483,7,32,.219,26,34,.765,105,31,78,.397,21,47,.447,10,31,.323,22,31,.710,94
2019-11-15,BOS,GSW,W 105-100,240,37,91,.407,24,58,.414,13,33,.394,18,23,.783,105,34,82,.415,29,54,.537,5,28,.179,27,34,.794,100
2019-11-16,MIN,HOU,L 105-125,240,38,84,.452,26,46,.565,12,38,.316,17,23,.739,105,43,94,.457,24,45,.533,19,49,.388,20,22,.909,125
2019-11-18,CLE,NYK,L 105-123,240,36,76,.474,19,40,.475,17,36,.472,16,30,.533,105,44,98,.449,36,75,.480,8,23,.348,27,35,.771,123
2019-11-20,DEN,HOU,W 105-95,240,44,94,.468,35,67,.522,9,27,.333,8,15,.533,105,32,76,.421,20,38,.526,12,38,.316,19,25,.760,95
2019-11-29,IND,ATL,W 105-104 (OT),265,39,92,.424,33,66,.500,6,26,.231,21,28,.750,105,39,90,.433,30,58,.517,9,32,.281,17,18,.944,104
2019-11-29,GSW,MIA,L 105-122,240,30,77,.390,20,49,.408,10,28,.357,35,40,.875,105,44,82,.537,31,57,.544,13,25,.520,21,28,.750,122
2019-12-03,LAL,DEN,W 105-96,240,39,84,.464,32,60,.533,7,24,.292,20,30,.667,105,37,91,.407,31,62,.500,6,29,.207,16,17,.941,96
2019-12-06,SAS,SAC,W 105-104 (OT),265,41,96,.427,30,64,.469,11,32,.344,12,17,.706,105,40,102,.392,31,68,.456,9,34,.265,15,18,.833,104
2019-12-08,BRK,DEN,W 105-102,240,40,87,.460,33,59,.559,7,28,.250,18,23,.783,105,36,89,.404,18,47,.383,18,42,.429,12,14,.857,102
2019-12-08,CHI,MIA,L 105-110 (OT),265,35,80,.438,22,44,.500,13,36,.361,22,27,.815,105,32,77,.416,21,42,.500,11,35,.314,35,44,.795,110
2019-12-09,DET,NOP,W 105-103,240,36,85,.424,25,50,.500,11,35,.314,22,27,.815,105,40,91,.440,32,53,.604,8,38,.211,15,22,.682,103
2019-12-15,NYK,DEN,L 105-111,240,44,94,.468,36,62,.581,8,32,.250,9,10,.900,105,44,94,.468,34,66,.515,10,28,.357,13,19,.684,111
2019-12-17,IND,LAL,W 105-102,240,41,85,.482,31,60,.517,10,25,.400,13,20,.650,105,43,91,.473,35,60,.583,8,31,.258,8,17,.471,102
2019-12-19,BRK,SAS,L 105-118,240,35,83,.422,28,47,.596,7,36,.194,28,30,.933,105,43,96,.448,30,63,.476,13,33,.394,19,23,.826,118
2019-12-20,SAC,IND,L 105-119,240,41,91,.451,31,59,.525,10,32,.313,13,15,.867,105,45,86,.523,31,55,.564,14,31,.452,15,18,.833,119
2019-12-26,MIN,SAC,W 105-104 (2OT),290,36,104,.346,26,58,.448,10,46,.217,23,29,.793,105,37,107,.346,28,68,.412,9,39,.231,21,25,.840,104
2019-12-27,GSW,PHO,W 105-96,240,38,92,.413,29,65,.446,9,27,.333,20,25,.800,105,35,75,.467,28,42,.667,7,33,.212,19,24,.792,96
2019-12-30,MIA,WAS,L 105-123,240,33,73,.452,23,45,.511,10,28,.357,29,39,.744,105,43,84,.512,26,47,.553,17,37,.459,20,30,.667,123
2019-12-31,LAC,SAC,W 105-87,240,36,88,.409,24,52,.462,12,36,.333,21,22,.955,105,33,80,.413,25,52,.481,8,28,.286,13,19,.684,87
2020-01-03,ORL,MIA,W 105-85,240,33,81,.407,20,46,.435,13,35,.371,26,29,.897,105,30,80,.375,23,43,.535,7,37,.189,18,23,.783,85
2020-01-10,CHI,IND,L 105-116,240,37,80,.463,19,39,.487,18,41,.439,13,16,.813,105,48,84,.571,37,54,.685,11,30,.367,9,14,.643,116
2020-01-11,NOP,BOS,L 105-140,240,40,100,.400,26,55,.473,14,45,.311,11,18,.611,105,55,100,.550,41,71,.577,14,29,.483,16,18,.889,140
2020-01-12,SAS,TOR,W 105-104,240,38,87,.437,31,55,.564,7,32,.219,22,30,.733,105,39,96,.406,22,48,.458,17,48,.354,9,11,.818,104
2019-10-28,TOR,ORL,W 104-95,240,33,85,.388,23,46,.500,10,39,.256,28,30,.933,104,34,89,.382,22,50,.440,12,39,.308,15,18,.833,95
2019-11-01,BOS,NYK,W 104-102,240,33,74,.446,22,40,.550,11,34,.324,27,29,.931,104,37,93,.398,23,55,.418,14,38,.368,14,21,.667,102
2019-11-02,NOP,OKC,L 104-115,240,40,94,.426,29,62,.468,11,32,.344,13,22,.591,104,41,90,.456,26,53,.491,15,37,.405,18,23,.783,115
2019-11-06,PHI,UTA,L 104-106,240,33,80,.413,25,55,.455,8,25,.320,30,34,.882,104,41,89,.461,33,67,.493,8,22,.364,16,24,.667,106
2019-11-08,NOP,TOR,L 104-122,240,40,99,.404,30,58,.517,10,41,.244,14,21,.667,104,41,93,.441,22,50,.440,19,43,.442,21,24,.875,122
2019-11-10,LAL,TOR,L 104-113,240,41,94,.436,31,64,.484,10,30,.333,12,19,.632,104,43,89,.483,31,53,.585,12,36,.333,15,22,.682,113
2019-11-19,POR,NOP,L 104-115,240,40,92,.435,24,63,.381,16,29,.552,8,13,.615,104,41,93,.441,28,57,.491,13,36,.361,20,24,.833,115
2019-11-20,BOS,LAC,L 104-107 (OT),265,41,104,.394,29,59,.492,12,45,.267,10,14,.714,104,39,93,.419,22,48,.458,17,45,.378,12,16,.750,107
2019-11-20,NYK,PHI,L 104-109,240,40,84,.476,27,59,.458,13,25,.520,11,15,.733,104,39,89,.438,26,57,.456,13,32,.406,18,26,.692,109
2019-11-22,SAS,PHI,L 104-115,240,43,85,.506,37,67,.552,6,18,.333,12,16,.750,104,46,89,.517,36,63,.571,10,26,.385,13,19,.684,115
2019-11-23,POR,CLE,L 104-110,240,39,87,.448,25,47,.532,14,40,.350,12,16,.750,104,37,87,.425,27,56,.482,10,31,.323,26,32,.813,110
2019-11-23,MIL,DET,W 104-90,240,41,84,.488,28,47,.596,13,37,.351,9,18,.500,104,37,91,.407,27,56,.482,10,35,.286,6,10,.600,90
2019-11-23,NYK,SAS,L 104-111,240,40,93,.430,25,53,.472,15,40,.375,9,15,.600,104,40,75,.533,28,52,.538,12,23,.522,19,28,.679,111
2019-11-24,PHO,DEN,L 104-116,240,41,82,.500,29,47,.617,12,35,.343,10,12,.833,104,43,91,.473,29,60,.483,14,31,.452,16,23,.696,116
2019-11-25,SAS,LAL,L 104-114,240,41,88,.466,31,63,.492,10,25,.400,12,15,.800,104,44,89,.494,30,56,.536,14,33,.424,12,18,.667,114
2019-11-26,WAS,DEN,L 104-117,240,40,95,.421,30,55,.545,10,40,.250,14,21,.667,104,47,90,.522,41,66,.621,6,24,.250,17,23,.739,117
2019-11-27,CLE,ORL,L 104-116,240,37,81,.457,26,47,.553,11,34,.324,19,22,.864,104,45,93,.484,33,60,.550,12,33,.364,14,17,.824,116
2019-11-27,GSW,CHI,W 104-90,240,37,81,.457,26,52,.500,11,29,.379,19,26,.731,104,34,89,.382,24,60,.400,10,29,.345,12,18,.667,90
2019-11-29,ATL,IND,L 104-105 (OT),265,39,90,.433,30,58,.517,9,32,.281,17,18,.944,104,39,92,.424,33,66,.500,6,26,.231,21,28,.750,105
2019-11-29,NOP,OKC,L 104-109,240,39,87,.448,28,49,.571,11,38,.289,15,21,.714,104,43,90,.478,30,56,.536,13,34,.382,10,16,.625,109
2019-12-01,NOP,OKC,L 104-107,240,39,87,.448,22,49,.449,17,38,.447,9,10,.900,104,38,81,.469,27,48,.563,11,33,.333,20,26,.769,107
2019-12-01,NYK,BOS,L 104-113,240,35,76,.461,27,50,.540,8,26,.308,26,37,.703,104,41,93,.441,26,52,.500,15,41,.366,16,22,.727,113
2019-12-02,ATL,GSW,W 104-79,240,41,89,.461,33,60,.550,8,29,.276,14,15,.933,104,33,83,.398,30,66,.455,3,17,.176,10,12,.833,79
2019-12-02,CHO,PHO,L 104-109,240,38,84,.452,31,59,.525,7,25,.280,21,26,.808,104,39,88,.443,30,46,.652,9,42,.214,22,30,.733,109
2019-12-02,MEM,IND,L 104-117,240,38,89,.427,28,51,.549,10,38,.263,18,19,.947,104,44,88,.500,28,50,.560,16,38,.421,13,15,.867,117
2019-12-06,CHO,BRK,L 104-111,240,36,83,.434,19,43,.442,17,40,.425,15,17,.882,104,42,88,.477,27,50,.540,15,38,.395,12,15,.800,111
2019-12-06,SAC,SAS,L 104-105 (OT),265,40,102,.392,31,68,.456,9,34,.265,15,18,.833,104,41,96,.427,30,64,.469,11,32,.344,12,17,.706,105
2019-12-07,IND,NYK,W 104-103,240,41,85,.482,29,57,.509,12,28,.429,10,13,.769,104,39,96,.406,29,65,.446,10,31,.323,15,21,.714,103
2019-12-08,TOR,PHI,L 104-110,240,38,88,.432,27,55,.491,11,33,.333,17,20,.850,104,40,79,.506,26,47,.553,14,32,.438,16,21,.762,110
2019-12-09,OKC,UTA,W 104-90,240,40,85,.471,32,57,.561,8,28,.286,16,19,.842,104,36,89,.404,28,58,.483,8,31,.258,10,12,.833,90
2019-12-18,ORL,DEN,L 104-113,240,37,87,.425,26,58,.448,11,29,.379,19,21,.905,104,40,84,.476,29,57,.509,11,27,.407,22,25,.880,113
2019-12-18,PHI,MIA,L 104-108,240,38,90,.422,26,51,.510,12,39,.308,16,18,.889,104,40,85,.471,28,54,.519,12,31,.387,16,20,.800,108
2019-12-19,LAL,MIL,L 104-111,240,37,80,.463,25,45,.556,12,35,.343,18,23,.783,104,36,77,.468,20,38,.526,16,39,.410,23,32,.719,111
2019-12-22,LAL,DEN,L 104-128,240,39,83,.470,29,54,.537,10,29,.345,16,22,.727,104,45,92,.489,34,60,.567,11,32,.344,27,30,.900,128
2019-12-23,MIN,GSW,L 104-113,240,35,87,.402,24,53,.453,11,34,.324,23,29,.793,104,38,87,.437,26,57,.456,12,30,.400,25,30,.833,113
2019-12-23,UTA,MIA,L 104-107,240,39,90,.433,27,54,.500,12,36,.333,14,18,.778,104,37,90,.411,28,65,.431,9,25,.360,24,27,.889,107
2019-12-23,SAC,HOU,L 104-113,240,41,87,.471,34,57,.596,7,30,.233,15,23,.652,104,39,87,.448,24,48,.500,15,39,.385,20,23,.870,113
2019-12-25,HOU,GSW,L 104-116,240,37,100,.370,21,49,.429,16,51,.314,14,16,.875,104,41,87,.471,32,59,.542,9,28,.321,25,28,.893,116
2019-12-26,SAC,MIN,L 104-105 (2OT),290,37,107,.346,28,68,.412,9,39,.231,21,25,.840,104,36,104,.346,26,58,.448,10,46,.217,23,29,.793,105
2019-12-27,OKC,CHO,W 104-102 (OT),265,40,89,.449,35,58,.603,5,31,.161,19,31,.613,104,42,101,.416,35,62,.565,7,39,.179,11,18,.611,102
2019-12-29,CHO,MEM,L 104-117,240,37,86,.430,28,55,.509,9,31,.290,21,32,.656,104,45,93,.484,35,58,.603,10,35,.286,17,17,1.000,117
2019-12-30,UTA,DET,W 104-81,240,39,83,.470,29,57,.509,10,26,.385,16,20,.800,104,30,79,.380,26,65,.400,4,14,.286,17,23,.739,81
2019-12-31,DEN,HOU,L 104-130,240,45,97,.464,37,72,.514,8,25,.320,6,9,.667,104,46,87,.529,30,53,.566,16,34,.471,22,31,.710,130
2020-01-01,MIN,MIL,L 104-106,240,34,91,.374,19,45,.422,15,46,.326,21,28,.750,104,40,94,.426,31,58,.534,9,36,.250,17,26,.654,106
2020-01-04,CHI,BOS,L 104-111,240,34,80,.425,21,46,.457,13,34,.382,23,31,.742,104,43,82,.524,35,63,.556,8,19,.421,17,21,.810,111
2020-01-04,GSW,DET,L 104-111,240,33,82,.402,22,61,.361,11,21,.524,27,32,.844,104,43,83,.518,32,56,.571,11,27,.407,14,16,.875,111
2020-01-06,CHO,IND,L 104-115,240,37,81,.457,27,51,.529,10,30,.333,20,22,.909,104,47,89,.528,37,63,.587,10,26,.385,11,14,.786,115
2020-01-06,MIL,SAS,L 104-126,240,38,95,.400,23,50,.460,15,45,.333,13,14,.929,104,45,88,.511,26,53,.491,19,35,.543,17,19,.895,126
2020-01-08,NYK,UTA,L 104-128,240,42,97,.433,33,72,.458,9,25,.360,11,11,1.000,104,49,90,.544,33,47,.702,16,43,.372,14,23,.609,128
2020-01-12,LAC,DEN,L 104-114,240,38,84,.452,30,51,.588,8,33,.242,20,26,.769,104,37,77,.481,26,52,.500,11,25,.440,29,37,.784,114
2020-01-12,TOR,SAS,L 104-105,240,39,96,.406,22,48,.458,17,48,.354,9,11,.818,104,38,87,.437,31,55,.564,7,32,.219,22,30,.733,105
2020-01-13,MIN,OKC,L 104-117,240,38,91,.418,26,56,.464,12,35,.343,16,21,.762,104,41,82,.500,29,52,.558,12,30,.400,23,26,.885,117
2020-01-15,IND,MIN,W 104-99,240,44,85,.518,37,62,.597,7,23,.304,9,12,.750,104,38,88,.432,27,60,.450,11,28,.393,12,16,.750,99
2019-10-26,ATL,ORL,W 103-99,240,43,84,.512,34,54,.630,9,30,.300,8,15,.533,103,35,99,.354,30,68,.441,5,31,.161,24,26,.923,99
2019-10-28,ATL,PHI,L 103-105,240,36,84,.429,27,57,.474,9,27,.333,22,32,.688,103,37,88,.420,26,47,.553,11,41,.268,20,25,.800,105
2019-10-31,LAC,SAS,W 103-97,240,39,91,.429,34,65,.523,5,26,.192,20,27,.741,103,36,80,.450,29,59,.492,7,21,.333,18,27,.667,97
2019-11-03,LAL,SAS,W 103-96,240,42,87,.483,36,63,.571,6,24,.250,13,19,.684,103,33,83,.398,27,58,.466,6,25,.240,24,29,.828,96
2019-11-08,UTA,MIL,W 103-100,240,34,84,.405,19,48,.396,15,36,.417,20,29,.690,103,34,95,.358,24,59,.407,10,36,.278,22,30,.733,100
Date,Tm,Opp,Result,MP,FG_T,FGA_T,FG%_T,2P_T,2PA_T,2P%_T,3P_T,3PA_T,3P%_T,FT_T,FTA_T,FT%_T,PTS_T,FG_O,FGA_O,FG%_O,2P_O,2PA_O,2P%_O,3P_O,3PA_O,3P%_O,FT_O,FTA_O,FT%_O,PTS_O
2019-11-14,DAL,NYK,L 103-106,240,36,84,.429,28,48,.583,8,36,.222,23,31,.742,103,42,94,.447,29,64,.453,13,30,.433,9,11,.818,106
2019-11-16,CHO,NYK,W 103-102,240,36,87,.414,19,39,.487,17,48,.354,14,19,.737,103,39,86,.453,33,66,.500,6,20,.300,18,23,.783,102
2019-11-20,UTA,MIN,W 103-95,240,35,86,.407,21,53,.396,14,33,.424,19,27,.704,103,35,89,.393,21,44,.477,14,45,.311,11,21,.524,95
2019-11-22,ATL,DET,L 103-128,240,38,88,.432,28,51,.549,10,37,.270,17,17,1.000,103,49,82,.598,32,48,.667,17,34,.500,13,20,.650,128
2019-11-24,BRK,NYK,W 103-101,240,31,77,.403,17,39,.436,14,38,.368,27,34,.794,103,37,80,.463,19,45,.422,18,35,.514,9,16,.563,101
2019-11-25,BOS,SAC,W 103-102,240,38,85,.447,31,55,.564,7,30,.233,20,23,.870,103,37,79,.468,19,32,.594,18,47,.383,10,15,.667,102
2019-11-25,DET,ORL,W 103-88,240,34,79,.430,20,41,.488,14,38,.368,21,25,.840,103,32,84,.381,24,59,.407,8,25,.320,16,22,.727,88
2019-11-29,WAS,LAL,L 103-125,240,38,96,.396,28,59,.475,10,37,.270,17,19,.895,103,45,87,.517,31,55,.564,14,32,.438,21,28,.750,125
2019-11-29,UTA,MEM,W 103-94,240,38,95,.400,26,60,.433,12,35,.343,15,19,.789,103,37,94,.394,27,60,.450,10,34,.294,10,17,.588,94
2019-11-29,CHI,POR,L 103-107,240,36,94,.383,22,56,.393,14,38,.368,17,25,.680,103,38,84,.452,28,54,.519,10,30,.333,21,28,.750,107
2019-12-02,PHI,UTA,W 103-94,240,37,91,.407,24,65,.369,13,26,.500,16,23,.696,103,38,81,.469,33,59,.559,5,22,.227,13,20,.650,94
2019-12-04,DET,MIL,L 103-127,240,39,93,.419,28,57,.491,11,36,.306,14,22,.636,103,44,90,.489,30,55,.545,14,35,.400,25,27,.926,127
2019-12-06,WAS,MIA,L 103-112,240,39,91,.429,27,52,.519,12,39,.308,13,14,.929,103,42,86,.488,32,58,.552,10,28,.357,18,24,.750,112
2019-12-07,NYK,IND,L 103-104,240,39,96,.406,29,65,.446,10,31,.323,15,21,.714,103,41,85,.482,29,57,.509,12,28,.429,10,13,.769,104
2019-12-09,NOP,DET,L 103-105,240,40,91,.440,32,53,.604,8,38,.211,15,22,.682,103,36,85,.424,25,50,.500,11,35,.314,22,27,.815,105
2019-12-13,NYK,SAC,W 103-101,240,44,95,.463,35,65,.538,9,30,.300,6,10,.600,103,39,83,.470,22,44,.500,17,39,.436,6,8,.750,101
2019-12-18,DAL,BOS,L 103-109,240,34,87,.391,19,44,.432,15,43,.349,20,25,.800,103,35,86,.407,23,48,.479,12,38,.316,27,30,.900,109
2019-12-20,ORL,POR,L 103-118,240,39,106,.368,32,78,.410,7,28,.250,18,26,.692,103,42,84,.500,25,48,.521,17,36,.472,17,19,.895,118
2019-12-23,ORL,CHI,W 103-95,240,39,81,.481,29,55,.527,10,26,.385,15,23,.652,103,35,88,.398,22,51,.431,13,37,.351,12,15,.800,95
2020-01-02,SAS,OKC,L 103-109,240,40,92,.435,27,61,.443,13,31,.419,10,12,.833,103,43,89,.483,34,64,.531,9,25,.360,14,20,.700,109
2020-01-03,WAS,POR,L 103-122,240,38,90,.422,27,57,.474,11,33,.333,16,25,.640,103,45,88,.511,39,63,.619,6,25,.240,26,33,.788,122
2020-01-05,CLE,MIN,L 103-118,240,40,84,.476,32,59,.542,8,25,.320,15,19,.789,103,47,95,.495,33,57,.579,14,38,.368,10,13,.769,118
2020-01-07,BRK,OKC,L 103-111 (OT),265,40,98,.408,29,61,.475,11,37,.297,12,16,.750,103,38,92,.413,27,55,.491,11,37,.297,24,29,.828,111
2020-01-07,PHO,SAC,L 103-114,240,37,77,.481,26,42,.619,11,35,.314,18,22,.818,103,37,84,.440,22,48,.458,15,36,.417,25,28,.893,114
2020-01-11,DEN,CLE,L 103-111,240,41,95,.432,33,56,.589,8,39,.205,13,18,.722,103,44,89,.494,32,52,.615,12,37,.324,11,13,.846,111
2020-01-14,CLE,LAC,L 103-128,240,38,91,.418,24,54,.444,14,37,.378,13,15,.867,103,49,94,.521,34,56,.607,15,38,.395,15,21,.714,128
2020-01-15,BOS,DET,L 103-116,240,41,83,.494,32,55,.582,9,28,.321,12,20,.600,103,47,78,.603,35,46,.761,12,32,.375,10,19,.526,116
2019-10-22,LAL,LAC,L 102-112,240,37,85,.435,24,52,.462,13,33,.394,15,21,.714,102,42,81,.519,31,50,.620,11,31,.355,17,24,.708,112
2019-10-25,MEM,CHI,L 102-110,240,39,94,.415,29,65,.446,10,29,.345,14,20,.700,102,40,93,.430,28,51,.549,12,42,.286,18,24,.750,110
2019-10-30,POR,OKC,W 102-99,240,34,86,.395,17,51,.333,17,35,.486,17,24,.708,102,33,84,.393,29,57,.509,4,27,.148,29,37,.784,99
2019-11-01,NYK,BOS,L 102-104,240,37,93,.398,23,55,.418,14,38,.368,14,21,.667,102,33,74,.446,22,40,.550,11,34,.324,27,29,.931,104
2019-11-01,IND,CLE,W 102-95,240,39,96,.406,34,69,.493,5,27,.185,19,21,.905,102,32,87,.368,21,55,.382,11,32,.344,20,25,.800,95
2019-11-01,SAC,UTA,W 102-101,240,41,84,.488,33,55,.600,8,29,.276,12,17,.706,102,35,73,.479,24,45,.533,11,28,.393,20,27,.741,101
2019-11-05,OKC,ORL,W 102-94,240,37,86,.430,25,53,.472,12,33,.364,16,20,.800,102,32,82,.390,29,60,.483,3,22,.136,27,31,.871,94
2019-11-06,NYK,DET,L 102-122,240,39,80,.488,28,55,.509,11,25,.440,13,21,.619,102,44,79,.557,29,49,.592,15,30,.500,19,24,.792,122
2019-11-08,DAL,NYK,L 102-106,240,37,90,.411,23,46,.500,14,44,.318,14,17,.824,102,37,89,.416,23,61,.377,14,28,.500,18,31,.581,106
2019-11-10,ORL,IND,L 102-109,240,41,89,.461,26,53,.491,15,36,.417,5,6,.833,102,48,91,.527,39,71,.549,9,20,.450,4,5,.800,109
2019-11-12,NYK,CHI,L 102-120,240,36,88,.409,26,56,.464,10,32,.313,20,31,.645,102,41,81,.506,27,48,.563,14,33,.424,24,31,.774,120
2019-11-13,HOU,LAC,W 102-93,240,33,86,.384,19,44,.432,14,42,.333,22,27,.815,102,38,98,.388,28,65,.431,10,33,.303,7,14,.500,93
2019-11-15,IND,HOU,L 102-111,240,37,82,.451,29,49,.592,8,33,.242,20,26,.769,102,36,89,.404,22,43,.512,14,46,.304,25,29,.862,111
2019-11-16,TOR,DAL,L 102-110,240,37,89,.416,20,48,.417,17,41,.415,11,15,.733,102,37,88,.420,28,49,.571,9,39,.231,27,33,.818,110
2019-11-16,MIL,IND,W 102-83,240,43,96,.448,32,57,.561,11,39,.282,5,7,.714,102,32,100,.320,20,66,.303,12,34,.353,7,9,.778,83
2019-11-16,NYK,CHO,L 102-103,240,39,86,.453,33,66,.500,6,20,.300,18,23,.783,102,36,87,.414,19,39,.487,17,48,.354,14,19,.737,103
2019-11-18,UTA,MIN,L 102-112,240,35,96,.365,23,65,.354,12,31,.387,20,26,.769,102,41,89,.461,27,51,.529,14,38,.368,16,19,.842,112
2019-11-25,SAC,BOS,L 102-103,240,37,79,.468,19,32,.594,18,47,.383,10,15,.667,102,38,85,.447,31,55,.564,7,30,.233,20,23,.870,103
2019-11-27,CHO,DET,W 102-101,240,39,88,.443,32,58,.552,7,30,.233,17,20,.850,102,41,88,.466,31,56,.554,10,32,.313,9,15,.600,101
2019-11-27,UTA,IND,L 102-121,240,36,83,.434,26,51,.510,10,32,.313,20,25,.800,102,50,96,.521,42,74,.568,8,22,.364,13,16,.813,121
2019-11-27,ATL,MIL,L 102-111,240,38,94,.404,27,60,.450,11,34,.324,15,22,.682,102,42,88,.477,32,54,.593,10,34,.294,17,27,.630,111
2019-12-08,DEN,BRK,L 102-105,240,36,89,.404,18,47,.383,18,42,.429,12,14,.857,102,40,87,.460,33,59,.559,7,28,.250,18,23,.783,105
2019-12-09,GSW,MEM,L 102-110,240,35,93,.376,24,66,.364,11,27,.407,21,25,.840,102,41,82,.500,26,42,.619,15,40,.375,13,17,.765,110
2019-12-11,ATL,CHI,L 102-136,240,35,83,.422,22,45,.489,13,38,.342,19,26,.731,102,54,94,.574,43,70,.614,11,24,.458,17,19,.895,136
2019-12-14,OKC,DEN,L 102-110,240,38,81,.469,32,58,.552,6,23,.261,20,23,.870,102,43,85,.506,36,58,.621,7,27,.259,17,23,.739,110
2019-12-14,BRK,TOR,L 102-110,240,39,101,.386,27,55,.491,12,46,.261,12,17,.706,102,38,98,.388,24,58,.414,14,40,.350,20,25,.800,110
2019-12-17,SAC,CHO,L 102-110,240,38,91,.418,24,52,.462,14,39,.359,12,13,.923,102,39,81,.481,26,51,.510,13,30,.433,19,27,.704,110
2019-12-17,LAL,IND,L 102-105,240,43,91,.473,35,60,.583,8,31,.258,8,17,.471,102,41,85,.482,31,60,.517,10,25,.400,13,20,.650,105
2019-12-17,ORL,UTA,L 102-109,240,42,93,.452,35,58,.603,7,35,.200,11,15,.733,102,42,90,.467,27,54,.500,15,36,.417,10,16,.625,109
2019-12-20,NOP,GSW,L 102-106,240,39,93,.419,30,59,.508,9,34,.265,15,23,.652,102,36,83,.434,26,50,.520,10,33,.303,24,25,.960,106
2019-12-21,NYK,MIL,L 102-123,240,39,97,.402,30,67,.448,9,30,.300,15,21,.714,102,41,85,.482,23,42,.548,18,43,.419,23,35,.657,123
2019-12-23,NOP,POR,W 102-94,240,38,93,.409,23,58,.397,15,35,.429,11,16,.688,102,37,91,.407,33,62,.532,4,29,.138,16,18,.889,94
2019-12-25,TOR,BOS,L 102-118,240,38,80,.475,30,57,.526,8,23,.348,18,22,.818,102,46,92,.500,32,59,.542,14,33,.424,12,14,.857,118
2019-12-26,DAL,SAS,W 102-98,240,38,90,.422,22,50,.440,16,40,.400,10,15,.667,102,40,83,.482,32,54,.593,8,29,.276,10,15,.667,98
2019-12-26,WAS,DET,L 102-132,240,38,92,.413,31,68,.456,7,24,.292,19,27,.704,102,46,86,.535,27,38,.711,19,48,.396,21,26,.808,132
2019-12-27,CHO,OKC,L 102-104 (OT),265,42,101,.416,35,62,.565,7,39,.179,11,18,.611,102,40,89,.449,35,58,.603,5,31,.161,19,31,.613,104
2019-12-30,CHI,MIL,L 102-123,240,40,107,.374,23,63,.365,17,44,.386,5,8,.625,102,46,84,.548,35,52,.673,11,32,.344,20,24,.833,123
2020-01-02,UTA,CHI,W 102-98,240,37,76,.487,26,46,.565,11,30,.367,17,22,.773,102,37,94,.394,26,58,.448,11,36,.306,13,17,.765,98
2020-01-04,BRK,TOR,L 102-121,240,32,67,.478,19,32,.594,13,35,.371,25,34,.735,102,44,97,.454,31,65,.477,13,32,.406,20,28,.714,121
2020-01-09,POR,MIN,L 102-116,240,35,96,.365,24,59,.407,11,37,.297,21,31,.677,102,44,89,.494,31,57,.544,13,32,.406,15,21,.714,116
2020-01-12,GSW,MEM,L 102-122,240,35,92,.380,18,58,.310,17,34,.500,15,21,.714,102,45,100,.450,34,65,.523,11,35,.314,21,25,.840,122
2020-01-14,NYK,MIL,L 102-128,240,36,102,.353,25,65,.385,11,37,.297,19,26,.731,102,45,92,.489,30,56,.536,15,36,.417,23,28,.821,128
2019-10-23,MEM,MIA,L 101-120,240,38,89,.427,33,57,.579,5,32,.156,20,30,.667,101,40,85,.471,33,67,.493,7,18,.389,33,39,.846,120
2019-10-27,CHO,LAL,L 101-120,240,35,91,.385,25,56,.446,10,35,.286,21,23,.913,101,49,93,.527,38,62,.613,11,31,.355,11,14,.786,120
2019-10-28,DEN,SAC,W 101-94,240,36,98,.367,26,62,.419,10,36,.278,19,21,.905,101,36,91,.396,24,54,.444,12,37,.324,10,16,.625,94
2019-11-01,UTA,SAC,L 101-102,240,35,73,.479,24,45,.533,11,28,.393,20,27,.741,101,41,84,.488,33,55,.600,8,29,.276,12,17,.706,102
2019-11-07,POR,LAC,L 101-107,240,39,104,.375,28,65,.431,11,39,.282,12,16,.750,101,39,89,.438,35,66,.530,4,23,.174,25,30,.833,107
2019-11-14,DEN,BRK,W 101-93,240,43,101,.426,33,68,.485,10,33,.303,5,10,.500,101,36,95,.379,28,57,.491,8,38,.211,13,16,.813,93
2019-11-16,ATL,LAC,L 101-150,240,34,90,.378,28,66,.424,6,24,.250,27,37,.730,101,50,93,.538,33,60,.550,17,33,.515,33,35,.943,150
2019-11-17,ATL,LAL,L 101-122,240,37,86,.430,29,58,.500,8,28,.286,19,25,.760,101,47,89,.528,32,54,.593,15,35,.429,13,16,.813,122
2019-11-18,CHI,MIL,L 101-115,240,39,97,.402,27,63,.429,12,34,.353,11,14,.786,101,38,82,.463,23,41,.561,15,41,.366,24,35,.686,115
2019-11-20,BRK,CHO,W 101-91,240,36,90,.400,26,51,.510,10,39,.256,19,23,.826,101,30,81,.370,19,48,.396,11,33,.333,20,26,.769,91
2019-11-22,CLE,DAL,L 101-143,240,37,86,.430,25,57,.439,12,29,.414,15,17,.882,101,58,100,.580,38,63,.603,20,37,.541,7,9,.778,143
2019-11-24,NYK,BRK,L 101-103,240,37,80,.463,19,45,.422,18,35,.514,9,16,.563,101,31,77,.403,17,39,.436,14,38,.368,27,34,.794,103
2019-11-25,TOR,PHI,W 101-96,240,38,84,.452,27,50,.540,11,34,.324,14,22,.636,101,36,88,.409,21,48,.438,15,40,.375,9,16,.563,96
2019-11-27,DET,CHO,L 101-102,240,41,88,.466,31,56,.554,10,32,.313,9,15,.600,101,39,88,.443,32,58,.552,7,30,.233,17,20,.850,102
2019-11-27,SAS,MIN,L 101-113,240,41,97,.423,36,68,.529,5,29,.172,14,17,.824,101,37,85,.435,19,45,.422,18,40,.450,21,27,.778,113
2019-11-29,PHI,NYK,W 101-95,240,31,72,.431,24,46,.522,7,26,.269,32,40,.800,101,34,78,.436,26,58,.448,8,20,.400,19,33,.576,95
2019-12-06,IND,DET,L 101-108,240,38,83,.458,29,59,.492,9,24,.375,16,20,.800,101,39,87,.448,28,62,.452,11,25,.440,19,26,.731,108
2019-12-09,ORL,MIL,L 101-110,240,35,92,.380,25,61,.410,10,31,.323,21,26,.808,101,43,92,.467,27,51,.529,16,41,.390,8,15,.533,110
2019-12-13,SAC,NYK,L 101-103,240,39,83,.470,22,44,.500,17,39,.436,6,8,.750,101,44,95,.463,35,65,.538,9,30,.300,6,10,.600,103
2019-12-15,LAL,ATL,W 101-96,240,36,84,.429,31,53,.585,5,31,.161,24,33,.727,101,31,86,.360,19,44,.432,12,42,.286,22,25,.880,96
2019-12-17,NOP,BRK,L 101-108 (OT),265,37,107,.346,26,67,.388,11,40,.275,16,24,.667,101,40,96,.417,29,57,.509,11,39,.282,17,23,.739,108
2019-12-30,ATL,ORL,W 101-93,240,39,81,.481,30,52,.577,9,29,.310,14,17,.824,101,37,89,.416,32,64,.500,5,25,.200,14,24,.583,93
2019-12-31,DAL,OKC,L 101-106,240,33,93,.355,18,42,.429,15,51,.294,20,27,.741,101,39,91,.429,33,64,.516,6,27,.222,22,28,.786,106
2020-01-01,WAS,ORL,L 101-122,240,33,87,.379,24,56,.429,9,31,.290,26,31,.839,101,45,95,.474,33,63,.524,12,32,.375,20,27,.741,122
2020-01-06,ORL,BRK,W 101-89,240,35,81,.432,27,55,.491,8,26,.308,23,31,.742,101,32,96,.333,22,49,.449,10,47,.213,15,19,.789,89
2020-01-07,POR,TOR,W 101-99,240,38,88,.432,25,53,.472,13,35,.371,12,14,.857,101,35,96,.365,20,54,.370,15,42,.357,14,19,.737,99
2020-01-10,ATL,WAS,L 101-111,240,41,89,.461,34,60,.567,7,29,.241,12,24,.500,101,42,112,.375,32,83,.386,10,29,.345,17,28,.607,111
2020-01-11,POR,MIL,L 101-122,240,37,95,.389,27,59,.458,10,36,.278,17,21,.810,101,47,103,.456,33,65,.508,14,38,.368,14,20,.700,122
2020-01-13,CHI,BOS,L 101-113,240,37,81,.457,31,56,.554,6,25,.240,21,26,.808,101,39,83,.470,30,60,.500,9,23,.391,26,29,.897,113
2020-01-13,IND,PHI,W 101-95,240,33,86,.384,23,60,.383,10,26,.385,25,31,.806,101,37,89,.416,31,56,.554,6,33,.182,15,19,.789,95
2019-10-23,WAS,DAL,L 100-108,240,37,93,.398,26,52,.500,11,41,.268,15,18,.833,100,35,76,.461,24,40,.600,11,36,.306,27,33,.818,108
Date,Tm,Opp,Result,MP,FG_T,FGA_T,FG%_T,2P_T,2PA_T,2P%_T,3P_T,3PA_T,3P%_T,FT_T,FTA_T,FT%_T,PTS_T,FG_O,FGA_O,FG%_O,2P_O,2PA_O,2P%_O,3P_O,3PA_O,3P%_O,FT_O,FTA_O,FT%_O,PTS_O
2019-10-23,POR,DEN,L 100-108,240,36,87,.414,29,59,.492,7,28,.250,21,23,.913,100,34,81,.420,16,49,.327,18,32,.563,22,27,.815,108
2019-10-23,UTA,OKC,W 100-95,240,40,90,.444,34,66,.515,6,24,.250,14,20,.700,100,32,83,.386,22,56,.393,10,27,.370,21,31,.677,95
2019-10-24,DET,ATL,L 100-117,240,35,85,.412,25,48,.521,10,37,.270,20,22,.909,100,44,86,.512,33,55,.600,11,31,.355,18,21,.857,117
2019-11-03,HOU,MIA,L 100-129,240,31,79,.392,17,31,.548,14,48,.292,24,31,.774,100,47,89,.528,29,48,.604,18,41,.439,17,22,.773,129
2019-11-04,MEM,HOU,L 100-107,240,40,94,.426,37,69,.536,3,25,.120,17,21,.810,100,35,93,.376,18,43,.419,17,50,.340,20,29,.690,107
2019-11-05,SAS,ATL,L 100-108,240,38,91,.418,30,58,.517,8,33,.242,16,23,.696,100,43,90,.478,32,60,.533,11,30,.367,11,16,.688,108
2019-11-08,DEN,PHI,W 100-97,240,39,87,.448,30,65,.462,9,22,.409,13,17,.765,100,38,86,.442,25,60,.417,13,26,.500,8,17,.471,97
2019-11-08,MIL,UTA,L 100-103,240,34,95,.358,24,59,.407,10,36,.278,22,30,.733,100,34,84,.405,19,48,.396,15,36,.417,20,29,.690,103
2019-11-08,WAS,CLE,L 100-113,240,45,96,.469,38,65,.585,7,31,.226,3,6,.500,100,41,90,.456,35,63,.556,6,27,.222,25,29,.862,113
2019-11-10,DEN,MIN,W 100-98 (OT),265,39,101,.386,28,73,.384,11,28,.393,11,17,.647,100,34,97,.351,28,52,.538,6,45,.133,24,33,.727,98
2019-11-15,GSW,BOS,L 100-105,240,34,82,.415,29,54,.537,5,28,.179,27,34,.794,100,37,91,.407,24,58,.414,13,33,.394,18,23,.783,105
2019-11-17,GSW,NOP,L 100-108,240,37,91,.407,30,66,.455,7,25,.280,19,23,.826,100,37,89,.416,19,43,.442,18,46,.391,16,20,.800,108
2019-11-17,SAC,BOS,W 100-99,240,38,89,.427,24,54,.444,14,35,.400,10,12,.833,100,34,82,.415,24,52,.462,10,30,.333,21,24,.875,99
2019-11-20,CLE,MIA,L 100-124,240,37,87,.425,25,49,.510,12,38,.316,14,16,.875,100,41,78,.526,22,41,.537,19,37,.514,23,31,.742,124
2019-11-23,PHO,MIN,W 100-98,240,33,96,.344,23,61,.377,10,35,.286,24,26,.923,100,38,91,.418,26,49,.531,12,42,.286,10,17,.588,98
2019-11-25,OKC,GSW,W 100-97,240,40,85,.471,29,53,.547,11,32,.344,9,11,.818,100,37,89,.416,28,69,.406,9,20,.450,14,16,.875,97
2019-11-25,CHO,MIA,L 100-117,240,36,87,.414,27,54,.500,9,33,.273,19,25,.760,100,40,77,.519,27,46,.587,13,31,.419,24,28,.857,117
2019-11-30,SAC,DEN,W 100-97 (OT),265,37,96,.385,29,63,.460,8,33,.242,18,21,.857,100,36,87,.414,25,55,.455,11,32,.344,14,21,.667,97
2019-12-01,LAL,DAL,L 100-114,240,40,87,.460,33,60,.550,7,27,.259,13,16,.813,100,42,97,.433,25,48,.521,17,49,.347,13,18,.722,114
2019-12-01,ORL,GSW,W 100-96,240,37,87,.425,26,54,.481,11,33,.333,15,22,.682,100,36,91,.396,30,68,.441,6,23,.261,18,23,.783,96
2019-12-04,OKC,IND,L 100-107,240,41,84,.488,32,58,.552,9,26,.346,9,10,.900,100,42,87,.483,33,63,.524,9,24,.375,14,17,.824,107
2019-12-06,GSW,CHI,W 100-98,240,38,71,.535,29,47,.617,9,24,.375,15,22,.682,100,39,88,.443,22,47,.468,17,41,.415,3,5,.600,98
2019-12-13,ATL,IND,L 100-110,240,39,94,.415,33,66,.500,6,28,.214,16,23,.696,100,46,92,.500,39,70,.557,7,22,.318,11,15,.733,110
2019-12-15,SAC,GSW,W 100-79,240,38,63,.603,28,41,.683,10,22,.455,14,16,.875,100,30,76,.395,24,51,.471,6,25,.240,13,18,.722,79
2019-12-18,CLE,CHO,W 100-98,240,40,74,.541,33,48,.688,7,26,.269,13,17,.765,100,37,91,.407,24,54,.444,13,37,.351,11,18,.611,98
2019-12-20,MIN,DEN,L 100-109,240,36,87,.414,26,45,.578,10,42,.238,18,27,.667,100,44,89,.494,34,61,.557,10,28,.357,11,12,.917,109
2019-12-25,DEN,NOP,L 100-112,240,37,92,.402,25,55,.455,12,37,.324,14,18,.778,100,41,90,.456,23,47,.489,18,43,.419,12,12,1.000,112
2019-12-28,ORL,MIL,L 100-111,240,35,87,.402,21,52,.404,14,35,.400,16,19,.842,100,43,84,.512,30,47,.638,13,37,.351,12,18,.667,111
2019-12-28,WAS,NYK,L 100-107,240,33,96,.344,23,71,.324,10,25,.400,24,31,.774,100,38,85,.447,27,54,.500,11,31,.355,20,26,.769,107
2020-01-10,GSW,LAC,L 100-109,240,37,96,.385,29,57,.509,8,39,.205,18,25,.720,100,41,84,.488,30,45,.667,11,39,.282,16,22,.727,109
2020-01-12,PHO,CHO,W 100-92,240,41,82,.500,34,61,.557,7,21,.333,11,18,.611,100,36,86,.419,28,51,.549,8,35,.229,12,18,.667,92
2020-01-15,DEN,CHO,W 100-86,240,38,79,.481,29,51,.569,9,28,.321,15,25,.600,100,33,81,.407,21,46,.457,12,35,.343,8,14,.571,86
2020-01-15,SAS,MIA,L 100-106,240,39,89,.438,29,56,.518,10,33,.303,12,15,.800,100,41,88,.466,24,48,.500,17,40,.425,7,13,.538,106
2020-01-17,PHI,CHI,W 100-89,240,40,82,.488,31,53,.585,9,29,.310,11,11,1.000,100,35,81,.432,27,46,.587,8,35,.229,11,15,.733,89
2019-10-25,CHO,MIN,L 99-121,240,37,84,.440,25,55,.455,12,29,.414,13,26,.500,99,43,91,.473,31,53,.585,12,38,.316,23,31,.742,121
2019-10-26,ORL,ATL,L 99-103,240,35,99,.354,30,68,.441,5,31,.161,24,26,.923,99,43,84,.512,34,54,.630,9,30,.300,8,15,.533,103
2019-10-26,IND,CLE,L 99-110,240,39,87,.448,29,59,.492,10,28,.357,11,13,.846,99,40,80,.500,29,49,.592,11,31,.355,19,29,.655,110
2019-10-30,OKC,POR,L 99-102,240,33,84,.393,29,57,.509,4,27,.148,29,37,.784,99,34,86,.395,17,51,.333,17,35,.486,17,24,.708,102
2019-11-04,DET,WAS,L 99-115,240,34,82,.415,21,55,.382,13,27,.481,18,23,.783,99,43,93,.462,35,64,.547,8,29,.276,21,25,.840,115
2019-11-12,POR,SAC,L 99-107,240,34,77,.442,26,47,.553,8,30,.267,23,30,.767,99,38,86,.442,27,54,.500,11,32,.344,20,26,.769,107
2019-11-15,LAL,SAC,W 99-97,240,34,81,.420,23,44,.523,11,37,.297,20,22,.909,99,36,82,.439,20,43,.465,16,39,.410,9,9,1.000,97
2019-11-17,BOS,SAC,L 99-100,240,34,82,.415,24,52,.462,10,30,.333,21,24,.875,99,38,89,.427,24,54,.444,14,35,.400,10,12,.833,100
2019-11-18,BOS,PHO,W 99-85,240,37,89,.416,25,48,.521,12,41,.293,13,17,.765,99,33,82,.402,23,46,.500,10,36,.278,9,12,.750,85
2019-11-26,DAL,LAC,L 99-114,240,30,79,.380,19,41,.463,11,38,.289,28,35,.800,99,41,97,.423,30,64,.469,11,33,.333,21,30,.700,114
2019-12-04,MEM,CHI,L 99-106,240,37,96,.385,30,66,.455,7,30,.233,18,21,.857,99,33,77,.429,20,44,.455,13,33,.394,27,37,.730,106
2019-12-09,IND,LAC,L 99-110,240,34,97,.351,24,62,.387,10,35,.286,21,28,.750,99,40,97,.412,30,65,.462,10,32,.313,20,27,.741,110
2019-12-12,POR,DEN,L 99-114,240,41,86,.477,32,56,.571,9,30,.300,8,11,.727,99,42,88,.477,24,52,.462,18,36,.500,12,19,.632,114
2019-12-17,PHO,LAC,L 99-120,240,41,102,.402,31,67,.463,10,35,.286,7,10,.700,99,45,89,.506,31,57,.544,14,32,.438,16,22,.727,120
2019-12-18,DET,TOR,L 99-112,240,39,87,.448,33,52,.635,6,35,.171,15,22,.682,99,39,91,.429,26,56,.464,13,35,.371,21,24,.875,112
2019-12-18,MIN,NOP,L 99-107,240,36,95,.379,26,56,.464,10,39,.256,17,27,.630,99,38,86,.442,24,53,.453,14,33,.424,17,21,.810,107
2020-01-02,MIN,GSW,W 99-84,240,38,95,.400,25,52,.481,13,43,.302,10,17,.588,99,33,77,.429,30,57,.526,3,20,.150,15,21,.714,84
2020-01-05,DET,LAL,L 99-106,240,29,78,.372,18,52,.346,11,26,.423,30,35,.857,99,42,92,.457,36,72,.500,6,20,.300,16,23,.696,106
2020-01-06,WAS,BOS,W 99-94,240,39,84,.464,32,63,.508,7,21,.333,14,23,.609,99,33,95,.347,25,58,.431,8,37,.216,20,26,.769,94
2020-01-07,TOR,POR,L 99-101,240,35,96,.365,20,54,.370,15,42,.357,14,19,.737,99,38,88,.432,25,53,.472,13,35,.371,12,14,.857,101
2020-01-11,DET,CHI,L 99-108,240,36,78,.462,27,50,.540,9,28,.321,18,27,.667,99,42,83,.506,31,48,.646,11,35,.314,13,14,.929,108
2020-01-13,CLE,LAL,L 99-128,240,38,85,.447,31,60,.517,7,25,.280,16,24,.667,99,48,88,.545,37,58,.638,11,30,.367,21,28,.750,128
2020-01-15,MIN,IND,L 99-104,240,38,88,.432,27,60,.450,11,28,.393,12,16,.750,99,44,85,.518,37,62,.597,7,23,.304,9,12,.750,104
2019-10-28,CHI,NYK,L 98-105,240,36,85,.424,27,50,.540,9,35,.257,17,21,.810,98,38,91,.418,29,62,.468,9,29,.310,20,32,.625,105
2019-11-10,MIN,DEN,L 98-100 (OT),265,34,97,.351,28,52,.538,6,45,.133,24,33,.727,98,39,101,.386,28,73,.384,11,28,.393,11,17,.647,100
2019-11-11,LAC,TOR,W 98-88,240,34,92,.370,26,56,.464,8,36,.222,22,30,.733,98,34,85,.400,23,55,.418,11,30,.367,9,15,.600,88
2019-11-12,PHI,CLE,W 98-97,240,40,89,.449,32,51,.627,8,38,.211,10,13,.769,98,38,86,.442,33,65,.508,5,21,.238,16,20,.800,97
2019-11-23,MIN,PHO,L 98-100,240,38,91,.418,26,49,.531,12,42,.286,10,17,.588,98,33,96,.344,23,61,.377,10,35,.286,24,26,.923,100
2019-11-27,NYK,TOR,L 98-126,240,33,88,.375,21,47,.447,12,41,.293,20,24,.833,98,46,94,.489,25,53,.472,21,41,.512,13,17,.765,126
2019-12-01,SAS,DET,L 98-132,240,36,88,.409,29,62,.468,7,26,.269,19,22,.864,98,52,88,.591,37,57,.649,15,31,.484,13,18,.722,132
2019-12-06,CHI,GSW,L 98-100,240,39,88,.443,22,47,.468,17,41,.415,3,5,.600,98,38,71,.535,29,47,.617,9,24,.375,15,22,.682,100
2019-12-18,CHO,CLE,L 98-100,240,37,91,.407,24,54,.444,13,37,.351,11,18,.611,98,40,74,.541,33,48,.688,7,26,.269,13,17,.765,100
2019-12-20,PHI,DAL,L 98-117,240,38,90,.422,28,56,.500,10,34,.294,12,18,.667,98,43,83,.518,29,50,.580,14,33,.424,17,22,.773,117
2019-12-26,SAS,DAL,L 98-102,240,40,83,.482,32,54,.593,8,29,.276,10,15,.667,98,38,90,.422,22,50,.440,16,40,.400,10,15,.667,102
2019-12-27,ORL,PHI,W 98-97,240,37,88,.420,27,58,.466,10,30,.333,14,23,.609,98,35,87,.402,25,58,.431,10,29,.345,17,21,.810,97
2019-12-28,BRK,HOU,L 98-108,240,37,92,.402,26,53,.491,11,39,.282,13,21,.619,98,44,101,.436,31,59,.525,13,42,.310,7,16,.438,108
2019-12-28,IND,NOP,L 98-120,240,33,85,.388,27,57,.474,6,28,.214,26,29,.897,98,43,93,.462,25,51,.490,18,42,.429,16,20,.800,120
2019-12-29,OKC,TOR,W 98-97,240,34,78,.436,24,45,.533,10,33,.303,20,23,.870,98,35,83,.422,20,43,.465,15,40,.375,12,12,1.000,97
2020-01-02,CHI,UTA,L 98-102,240,37,94,.394,26,58,.448,11,36,.306,13,17,.765,98,37,76,.487,26,46,.565,11,30,.367,17,22,.773,102
2020-01-06,GSW,SAC,L 98-111,240,34,86,.395,29,60,.483,5,26,.192,25,32,.781,98,39,81,.481,24,51,.471,15,30,.500,18,23,.783,111
2020-01-08,GSW,MIL,L 98-107,240,33,87,.379,18,49,.367,15,38,.395,17,20,.850,98,35,87,.402,26,46,.565,9,41,.220,28,32,.875,107
2020-01-09,BOS,PHI,L 98-109,240,38,88,.432,24,52,.462,14,36,.389,8,8,1.000,98,43,88,.489,32,61,.525,11,27,.407,12,17,.706,109
2020-01-10,PHO,ORL,W 98-94,240,33,79,.418,24,51,.471,9,28,.321,23,26,.885,98,33,89,.371,24,56,.429,9,33,.273,19,24,.792,94
2020-01-16,NYK,PHO,L 98-121,240,37,90,.411,29,64,.453,8,26,.308,16,24,.667,98,47,92,.511,35,62,.565,12,30,.400,15,18,.833,121
2019-10-25,WAS,OKC,W 97-85,240,39,97,.402,28,56,.500,11,41,.268,8,10,.800,97,33,83,.398,28,60,.467,5,23,.217,14,22,.636,85
2019-10-29,ATL,MIA,L 97-112,240,35,83,.422,24,44,.545,11,39,.282,16,24,.667,97,33,73,.452,20,42,.476,13,31,.419,33,45,.733,112
2019-10-31,ATL,MIA,L 97-106,240,36,88,.409,29,54,.537,7,34,.206,18,26,.692,97,40,84,.476,26,47,.553,14,37,.378,12,19,.632,106
2019-10-31,SAS,LAC,L 97-103,240,36,80,.450,29,59,.492,7,21,.333,18,27,.667,97,39,91,.429,34,65,.523,5,26,.192,20,27,.741,103
2019-11-08,PHI,DEN,L 97-100,240,38,86,.442,25,60,.417,13,26,.500,8,17,.471,97,39,87,.448,30,65,.462,9,22,.409,13,17,.765,100
2019-11-12,CLE,PHI,L 97-98,240,38,86,.442,33,65,.508,5,21,.238,16,20,.800,97,40,89,.449,32,51,.627,8,38,.211,10,13,.769,98
2019-11-13,PHI,ORL,L 97-112,240,40,91,.440,32,61,.525,8,30,.267,9,13,.692,97,38,86,.442,28,54,.519,10,32,.313,26,34,.765,112
2019-11-14,CLE,MIA,L 97-108,240,36,85,.424,28,53,.528,8,32,.250,17,21,.810,97,43,79,.544,31,49,.633,12,30,.400,10,11,.909,108
2019-11-15,SAC,LAL,L 97-99,240,36,82,.439,20,43,.465,16,39,.410,9,9,1.000,97,34,81,.420,23,44,.523,11,37,.297,20,22,.909,99
2019-11-20,ORL,TOR,L 97-113,240,35,91,.385,26,59,.441,9,32,.281,18,28,.643,97,45,87,.517,36,60,.600,9,27,.333,14,19,.737,113
2019-11-22,SAC,BRK,L 97-116,240,39,86,.453,35,60,.583,4,26,.154,15,19,.789,97,41,81,.506,29,47,.617,12,34,.353,22,31,.710,116
2019-11-25,GSW,OKC,L 97-100,240,37,89,.416,28,69,.406,9,20,.450,14,16,.875,97,40,85,.471,29,53,.547,11,32,.344,9,11,.818,100
2019-11-27,PHI,SAC,W 97-91,240,36,77,.468,31,51,.608,5,26,.192,20,24,.833,97,39,95,.411,30,61,.492,9,34,.265,4,9,.444,91
2019-11-29,LAC,SAS,L 97-107,240,36,92,.391,24,59,.407,12,33,.364,13,13,1.000,97,40,93,.430,26,57,.456,14,36,.389,13,14,.929,107
2019-11-30,DEN,SAC,L 97-100 (OT),265,36,87,.414,25,55,.455,11,32,.344,14,21,.667,97,37,96,.385,29,63,.460,8,33,.242,18,21,.857,100
2019-12-03,POR,LAC,L 97-117,240,39,91,.429,32,64,.500,7,27,.259,12,15,.800,97,43,94,.457,26,60,.433,17,34,.500,14,25,.560,117
2019-12-03,NOP,DAL,L 97-118,240,38,94,.404,27,53,.509,11,41,.268,10,15,.667,97,38,88,.432,19,43,.442,19,45,.422,23,27,.852,118
2019-12-10,PHI,DEN,W 97-92,240,37,89,.416,25,53,.472,12,36,.333,11,16,.688,97,37,85,.435,30,58,.517,7,27,.259,11,12,.917,92
2019-12-26,OKC,MEM,L 97-110,240,38,92,.413,28,57,.491,10,35,.286,11,13,.846,97,46,84,.548,36,59,.610,10,25,.400,8,11,.727,110
2019-12-27,PHI,ORL,L 97-98,240,35,87,.402,25,58,.431,10,29,.345,17,21,.810,97,37,88,.420,27,58,.466,10,30,.333,14,23,.609,98
2019-12-28,BOS,TOR,L 97-113,240,31,78,.397,24,46,.522,7,32,.219,28,36,.778,97,44,84,.524,30,50,.600,14,34,.412,11,17,.647,113
2019-12-29,TOR,OKC,L 97-98,240,35,83,.422,20,43,.465,15,40,.375,12,12,1.000,97,34,78,.436,24,45,.533,10,33,.303,20,23,.870,98
Date,Tm,Opp,Result,MP,FG_T,FGA_T,FG%_T,2P_T,2PA_T,2P%_T,3P_T,3PA_T,3P%_T,FT_T,FTA_T,FT%_T,PTS_T,FG_O,FGA_O,FG%_O,2P_O,2PA_O,2P%_O,3P_O,3PA_O,3P%_O,FT_O,FTA_O,FT%_O,PTS_O
2019-12-31,PHI,IND,L 97-115,240,37,91,.407,31,62,.500,6,29,.207,17,20,.850,97,42,86,.488,31,61,.508,11,25,.440,20,26,.769,115
2019-12-31,CLE,TOR,L 97-117,240,37,87,.425,27,49,.551,10,38,.263,13,16,.813,97,40,84,.476,23,45,.511,17,39,.436,20,25,.800,117
2020-01-14,GSW,DAL,L 97-124,240,39,87,.448,30,55,.545,9,32,.281,10,13,.769,97,49,96,.510,36,59,.610,13,37,.351,13,21,.619,124
2019-10-28,DET,IND,W 96-94,240,37,81,.457,24,57,.421,13,24,.542,9,10,.900,96,39,94,.415,33,73,.452,6,21,.286,10,13,.769,94
2019-10-28,CHO,LAC,L 96-111,240,36,83,.434,22,44,.500,14,39,.359,10,14,.714,96,40,83,.482,28,50,.560,12,33,.364,19,21,.905,111
2019-10-28,UTA,PHO,W 96-95,240,27,71,.380,17,40,.425,10,31,.323,32,39,.821,96,33,80,.413,20,46,.435,13,34,.382,16,23,.696,95
2019-10-30,LAC,UTA,L 96-110,240,39,82,.476,31,59,.525,8,23,.348,10,12,.833,96,44,80,.550,33,56,.589,11,24,.458,11,16,.688,110
2019-11-03,SAS,LAL,L 96-103,240,33,83,.398,27,58,.466,6,25,.240,24,29,.828,96,42,87,.483,36,63,.571,6,24,.250,13,19,.684,103
2019-11-18,CHO,TOR,L 96-132,240,33,78,.423,18,33,.545,15,45,.333,15,24,.625,96,50,97,.515,30,54,.556,20,43,.465,12,15,.800,132
2019-11-22,DEN,BOS,W 96-92,240,39,88,.443,32,60,.533,7,28,.250,11,13,.846,96,33,81,.407,26,54,.481,7,27,.259,19,23,.826,92
2019-11-25,PHI,TOR,L 96-101,240,36,88,.409,21,48,.438,15,40,.375,9,16,.563,96,38,84,.452,27,50,.540,11,34,.324,14,22,.636,101
2019-11-30,CHO,MIL,L 96-137,240,37,101,.366,22,56,.393,15,45,.333,7,8,.875,96,54,96,.563,34,52,.654,20,44,.455,9,15,.600,137
2019-12-01,GSW,ORL,L 96-100,240,36,91,.396,30,68,.441,6,23,.261,18,23,.783,96,37,87,.425,26,54,.481,11,33,.333,15,22,.682,100
2019-12-03,DEN,LAL,L 96-105,240,37,91,.407,31,62,.500,6,29,.207,16,17,.941,96,39,84,.464,32,60,.533,7,24,.292,20,30,.667,105
2019-12-04,UTA,LAL,L 96-121,240,34,83,.410,20,52,.385,14,31,.452,14,19,.737,96,46,90,.511,32,61,.525,14,29,.483,15,25,.600,121
2019-12-08,POR,OKC,L 96-108,240,36,100,.360,27,67,.403,9,33,.273,15,18,.833,96,35,85,.412,24,53,.453,11,32,.344,27,34,.794,108
2019-12-11,LAL,ORL,W 96-87,240,37,87,.425,25,56,.446,12,31,.387,10,19,.526,96,34,81,.420,26,55,.473,8,26,.308,11,17,.647,87
2019-12-15,ATL,LAL,L 96-101,240,31,86,.360,19,44,.432,12,42,.286,22,25,.880,96,36,84,.429,31,53,.585,5,31,.161,24,33,.727,101
2019-12-27,PHO,GSW,L 96-105,240,35,75,.467,28,42,.667,7,33,.212,19,24,.792,96,38,92,.413,29,65,.446,9,27,.333,20,25,.800,105
2020-01-04,ORL,UTA,L 96-109,240,38,85,.447,27,48,.563,11,37,.297,9,12,.750,96,42,93,.452,26,53,.491,16,40,.400,9,14,.643,109
2019-10-23,SAC,PHO,L 95-124,240,34,87,.391,24,58,.414,10,29,.345,17,26,.654,95,49,98,.500,38,65,.585,11,33,.333,15,18,.833,124
2019-10-23,OKC,UTA,L 95-100,240,32,83,.386,22,56,.393,10,27,.370,21,31,.677,95,40,90,.444,34,66,.515,6,24,.250,14,20,.700,100
2019-10-25,LAL,UTA,W 95-86,240,34,86,.395,26,60,.433,8,26,.308,19,24,.792,95,29,70,.414,21,45,.467,8,25,.320,20,21,.952,86
2019-10-26,NYK,BOS,L 95-118,240,31,82,.378,24,55,.436,7,27,.259,26,34,.765,95,42,93,.452,27,52,.519,15,41,.366,19,29,.655,118
2019-10-28,PHO,UTA,L 95-96,240,33,80,.413,20,46,.435,13,34,.382,16,23,.696,95,27,71,.380,17,40,.425,10,31,.323,32,39,.821,96
2019-10-28,ORL,TOR,L 95-104,240,34,89,.382,22,50,.440,12,39,.308,15,18,.833,95,33,85,.388,23,46,.500,10,39,.256,28,30,.933,104
2019-10-30,ORL,NYK,W 95-83,240,37,88,.420,25,56,.446,12,32,.375,9,12,.750,95,31,82,.378,24,51,.471,7,31,.226,14,20,.700,83
2019-10-30,MIN,PHI,L 95-117,240,32,81,.395,22,46,.478,10,35,.286,21,28,.750,95,43,92,.467,34,67,.507,9,25,.360,22,28,.786,117
2019-11-01,CLE,IND,L 95-102,240,32,87,.368,21,55,.382,11,32,.344,20,25,.800,95,39,96,.406,34,69,.493,5,27,.185,19,21,.905,102
2019-11-03,CHI,IND,L 95-108,240,36,84,.429,27,55,.491,9,29,.310,14,25,.560,95,40,85,.471,32,59,.542,8,26,.308,20,27,.741,108
2019-11-08,LAL,MIA,W 95-80,240,40,89,.449,32,57,.561,8,32,.250,7,8,.875,95,28,80,.350,22,45,.489,6,35,.171,18,24,.750,80
2019-11-17,CLE,PHI,L 95-114,240,34,90,.378,28,65,.431,6,25,.240,21,24,.875,95,46,84,.548,37,61,.607,9,23,.391,13,17,.765,114
2019-11-19,MEM,GSW,L 95-114,240,36,88,.409,27,63,.429,9,25,.360,14,19,.737,95,43,90,.478,34,61,.557,9,29,.310,19,22,.864,114
2019-11-20,HOU,DEN,L 95-105,240,32,76,.421,20,38,.526,12,38,.316,19,25,.760,95,44,94,.468,35,67,.522,9,27,.333,8,15,.533,105
2019-11-20,MIN,UTA,L 95-103,240,35,89,.393,21,44,.477,14,45,.311,11,21,.524,95,35,86,.407,21,53,.396,14,33,.424,19,27,.704,103
2019-11-29,NYK,PHI,L 95-101,240,34,78,.436,26,58,.448,8,20,.400,19,33,.576,95,31,72,.431,24,46,.522,7,26,.269,32,40,.800,101
2019-12-06,DEN,BOS,L 95-108,240,39,94,.415,34,64,.531,5,30,.167,12,15,.800,95,44,82,.537,31,47,.660,13,35,.371,7,8,.875,108
2019-12-23,CHI,ORL,L 95-103,240,35,88,.398,22,51,.431,13,37,.351,12,15,.800,95,39,81,.481,29,55,.527,10,26,.385,15,23,.652,103
2019-12-29,DAL,LAL,L 95-108,240,32,89,.360,19,46,.413,13,43,.302,18,20,.900,95,38,78,.487,29,55,.527,9,23,.391,23,28,.821,108
2020-01-13,PHI,IND,L 95-101,240,37,89,.416,31,56,.554,6,33,.182,15,19,.789,95,33,86,.384,23,60,.383,10,26,.385,25,31,.806,101
2020-01-16,ORL,LAC,L 95-122,240,36,92,.391,22,50,.440,14,42,.333,9,16,.563,95,47,95,.495,33,63,.524,14,32,.438,14,20,.700,122
2019-10-23,ORL,CLE,W 94-85,240,37,86,.430,28,56,.500,9,30,.300,11,19,.579,94,33,88,.375,24,54,.444,9,34,.265,10,15,.667,85
2019-10-28,IND,DET,L 94-96,240,39,94,.415,33,73,.452,6,21,.286,10,13,.769,94,37,81,.457,24,57,.421,13,24,.542,9,10,.900,96
2019-10-28,SAC,DEN,L 94-101,240,36,91,.396,24,54,.444,12,37,.324,10,16,.625,94,36,98,.367,26,62,.419,10,36,.278,19,21,.905,101
2019-11-03,UTA,LAC,L 94-105,240,31,78,.397,21,47,.447,10,31,.323,22,31,.710,94,36,92,.391,29,60,.483,7,32,.219,26,34,.765,105
2019-11-05,ORL,OKC,L 94-102,240,32,82,.390,29,60,.483,3,22,.136,27,31,.871,94,37,86,.430,25,53,.472,12,33,.364,16,20,.800,102
2019-11-09,CHI,HOU,L 94-117,240,37,98,.378,33,66,.500,4,32,.125,16,18,.889,94,39,83,.470,20,39,.513,19,44,.432,20,28,.714,117
2019-11-13,GSW,LAL,L 94-120,240,36,89,.404,27,54,.500,9,35,.257,13,17,.765,94,48,89,.539,39,69,.565,9,20,.450,15,18,.833,120
2019-11-16,NOP,MIA,L 94-109,240,37,82,.451,21,47,.447,16,35,.457,4,6,.667,94,44,81,.543,35,57,.614,9,24,.375,12,13,.923,109
2019-11-20,GSW,DAL,L 94-142,240,35,90,.389,27,63,.429,8,27,.296,16,25,.640,94,51,90,.567,29,52,.558,22,38,.579,18,23,.783,142
2019-11-25,CHI,POR,L 94-117,240,36,86,.419,27,47,.574,9,39,.231,13,20,.650,94,46,89,.517,38,62,.613,8,27,.296,17,22,.773,117
2019-11-29,MEM,UTA,L 94-103,240,37,94,.394,27,60,.450,10,34,.294,10,17,.588,94,38,95,.400,26,60,.433,12,35,.343,15,19,.789,103
2019-12-02,UTA,PHI,L 94-103,240,38,81,.469,33,59,.559,5,22,.227,13,20,.650,94,37,91,.407,24,65,.369,13,26,.500,16,23,.696,103
2019-12-03,CLE,DET,L 94-127,240,38,90,.422,30,63,.476,8,27,.296,10,14,.714,94,51,94,.543,33,59,.559,18,35,.514,7,11,.636,127
2019-12-07,CLE,PHI,L 94-141,240,36,96,.375,27,61,.443,9,35,.257,13,17,.765,94,57,90,.633,46,64,.719,11,26,.423,16,23,.696,141
2019-12-11,SAC,OKC,W 94-93,240,39,88,.443,29,57,.509,10,31,.323,6,10,.600,94,34,79,.430,21,46,.457,13,33,.394,12,18,.667,93
2019-12-23,POR,NOP,L 94-102,240,37,91,.407,33,62,.532,4,29,.138,16,18,.889,94,38,93,.409,23,58,.397,15,35,.429,11,16,.688,102
2019-12-26,NYK,BRK,W 94-82,240,37,92,.402,28,63,.444,9,29,.310,11,15,.733,94,21,78,.269,8,28,.286,13,50,.260,27,36,.750,82
2019-12-28,CLE,MIN,W 94-88,240,32,77,.416,28,57,.491,4,20,.200,26,36,.722,94,33,93,.355,25,56,.446,8,37,.216,14,19,.737,88
2020-01-06,BOS,WAS,L 94-99,240,33,95,.347,25,58,.431,8,37,.216,20,26,.769,94,39,84,.464,32,63,.508,7,21,.333,14,23,.609,99
2020-01-10,ORL,PHO,L 94-98,240,33,89,.371,24,56,.429,9,33,.273,19,24,.792,94,33,79,.418,24,51,.471,9,28,.321,23,26,.885,98
2019-10-23,BOS,PHI,L 93-107,240,33,90,.367,26,64,.406,7,26,.269,20,34,.588,93,37,85,.435,30,56,.536,7,29,.241,26,36,.722,107
2019-11-02,CHO,GSW,W 93-87,240,36,85,.424,31,56,.554,5,29,.172,16,23,.696,93,34,77,.442,25,49,.510,9,28,.321,10,13,.769,87
2019-11-06,ATL,CHI,L 93-113,240,30,74,.405,24,44,.545,6,30,.200,27,35,.771,93,41,82,.500,28,49,.571,13,33,.394,18,27,.667,113
2019-11-13,LAC,HOU,L 93-102,240,38,98,.388,28,65,.431,10,33,.303,7,14,.500,93,33,86,.384,19,44,.432,14,42,.333,22,27,.815,102
2019-11-14,BRK,DEN,L 93-101,240,36,95,.379,28,57,.491,8,38,.211,13,16,.813,93,43,101,.426,33,68,.485,10,33,.303,5,10,.500,101
2019-12-04,MIA,BOS,L 93-112,240,34,77,.442,20,39,.513,14,38,.368,11,17,.647,93,35,79,.443,19,38,.500,16,41,.390,26,32,.813,112
2019-12-06,ORL,CLE,W 93-87,240,32,82,.390,23,56,.411,9,26,.346,20,23,.870,93,35,83,.422,25,49,.510,10,34,.294,7,10,.700,87
2019-12-09,TOR,CHI,W 93-92,240,34,90,.378,27,61,.443,7,29,.241,18,26,.692,93,35,89,.393,23,43,.535,12,46,.261,10,14,.714,92
2019-12-11,OKC,SAC,L 93-94,240,34,79,.430,21,46,.457,13,33,.394,12,18,.667,93,39,88,.443,29,57,.509,10,31,.323,6,10,.600,94
2019-12-20,DET,BOS,L 93-114,240,34,85,.400,23,54,.426,11,31,.355,14,19,.737,93,45,86,.523,36,59,.610,9,27,.333,15,21,.714,114
2019-12-22,CHO,BOS,L 93-119,240,33,82,.402,23,48,.479,10,34,.294,17,23,.739,93,46,88,.523,32,56,.571,14,32,.438,13,16,.813,119
2019-12-30,ORL,ATL,L 93-101,240,37,89,.416,32,64,.500,5,25,.200,14,24,.583,93,39,81,.481,30,52,.577,9,29,.310,14,17,.824,101
2020-01-01,POR,NYK,L 93-117,240,37,94,.394,27,62,.435,10,32,.313,9,15,.600,93,47,98,.480,33,62,.532,14,36,.389,9,14,.643,117
2019-10-27,GSW,OKC,L 92-120,240,30,92,.326,25,59,.424,5,33,.152,27,31,.871,92,44,78,.564,29,46,.630,15,32,.469,17,22,.773,120
2019-11-03,NYK,SAC,L 92-113,240,32,80,.400,24,49,.490,8,31,.258,20,31,.645,92,41,85,.482,26,46,.565,15,39,.385,16,25,.640,113
2019-11-22,BOS,DEN,L 92-96,240,33,81,.407,26,54,.481,7,27,.259,19,23,.826,92,39,88,.443,32,60,.533,7,28,.250,11,13,.846,96
2019-12-05,NYK,DEN,L 92-129,240,34,83,.410,25,49,.510,9,34,.265,15,23,.652,92,49,87,.563,28,48,.583,21,39,.538,10,18,.556,129
2019-12-09,CHI,TOR,L 92-93,240,35,89,.393,23,43,.535,12,46,.261,10,14,.714,92,34,90,.378,27,61,.443,7,29,.241,18,26,.692,93
2019-12-10,DEN,PHI,L 92-97,240,37,85,.435,30,58,.517,7,27,.259,11,12,.917,92,37,89,.416,25,53,.472,12,36,.333,11,16,.688,97
2019-12-11,TOR,LAC,L 92-112,240,31,88,.352,23,52,.442,8,36,.222,22,25,.880,92,38,86,.442,26,46,.565,12,40,.300,24,27,.889,112
2019-12-31,CHO,BOS,L 92-109,240,34,86,.395,22,52,.423,12,34,.353,12,16,.750,92,44,97,.454,30,59,.508,14,38,.368,7,10,.700,109
2020-01-09,HOU,OKC,L 92-113,240,34,89,.382,23,49,.469,11,40,.275,13,14,.929,92,43,87,.494,32,55,.582,11,32,.344,16,20,.800,113
2020-01-10,CHO,UTA,L 92-109,240,35,75,.467,27,49,.551,8,26,.308,14,19,.737,92,40,79,.506,22,37,.595,18,42,.429,11,14,.786,109
2020-01-12,CHO,PHO,L 92-100,240,36,86,.419,28,51,.549,8,35,.229,12,18,.667,92,41,82,.500,34,61,.557,7,21,.333,11,18,.611,100
2019-10-29,MEM,LAL,L 91-120,240,31,95,.326,24,61,.393,7,34,.206,22,23,.957,91,40,86,.465,33,60,.550,7,26,.269,33,39,.846,120
2019-11-01,ORL,MIL,L 91-123,240,34,91,.374,22,54,.407,12,37,.324,11,17,.647,91,47,93,.505,30,46,.652,17,47,.362,12,18,.667,123
2019-11-02,DEN,ORL,W 91-87,240,27,73,.370,18,45,.400,9,28,.321,28,39,.718,91,37,86,.430,31,57,.544,6,29,.207,7,11,.636,87
2019-11-20,CHO,BRK,L 91-101,240,30,81,.370,19,48,.396,11,33,.333,20,26,.769,91,36,90,.400,26,51,.510,10,39,.256,19,23,.826,101
2019-11-27,SAC,PHI,L 91-97,240,39,95,.411,30,61,.492,9,34,.265,4,9,.444,91,36,77,.468,31,51,.608,5,26,.192,20,24,.833,97
2019-12-04,GSW,CHO,L 91-106,240,36,78,.462,27,55,.491,9,23,.391,10,15,.667,91,40,87,.460,19,39,.487,21,48,.438,5,8,.625,106
2019-12-06,LAC,MIL,L 91-119,240,33,94,.351,25,62,.403,8,32,.250,17,19,.895,91,44,94,.468,30,58,.517,14,36,.389,17,21,.810,119
2020-01-11,PHI,DAL,L 91-109,240,37,98,.378,28,61,.459,9,37,.243,8,12,.667,91,40,79,.506,29,52,.558,11,27,.407,18,27,.667,109
2019-11-18,LAC,OKC,W 90-88,240,35,87,.402,25,51,.490,10,36,.278,10,14,.714,90,28,75,.373,21,48,.438,7,27,.259,25,28,.893,88
2019-11-23,DET,MIL,L 90-104,240,37,91,.407,27,56,.482,10,35,.286,6,10,.600,90,41,84,.488,28,47,.596,13,37,.351,9,18,.500,104
2019-11-27,CHI,GSW,L 90-104,240,34,89,.382,24,60,.400,10,29,.345,12,18,.667,90,37,81,.457,26,52,.500,11,29,.379,19,26,.731,104
2019-11-29,TOR,ORL,W 90-83,240,31,84,.369,20,46,.435,11,38,.289,17,28,.607,90,27,78,.346,20,49,.408,7,29,.241,22,27,.815,83
2019-12-09,UTA,OKC,L 90-104,240,36,89,.404,28,58,.483,8,31,.258,10,12,.833,90,40,85,.471,32,57,.561,8,28,.286,16,19,.842,104
2019-11-05,MIA,DEN,L 89-109,240,32,88,.364,23,59,.390,9,29,.310,16,25,.640,89,45,86,.523,36,63,.571,9,23,.391,10,16,.625,109
2019-11-20,DET,CHI,L 89-109,240,28,83,.337,20,50,.400,8,33,.242,25,32,.781,89,39,91,.429,25,64,.391,14,27,.519,17,26,.654,109
